TTATCCGGATAAGGAG-1	Undefined
TTATCCGGTAGAGTAA-1	ForebrainGABAergic
TTATCCGGGCAGGTCC-1	ForebrainGABAergic
TTATCCGGTCGGCCTT-1	ForebrainGABAergic
TTATCCGGAGAACGTC-1	ForebrainGABAergic
TTATCCGGCTTGCGCC-1	ForebrainGABAergic
TTATCCGGGGTACTGC-1	ForebrainGABAergic
TTATCCGGTAGAATTA-1	ForebrainGABAergic
TTATCCGGGCCATTCT-1	ForebrainGABAergic
TTATCCGGTTGACTTC-1	ForebrainGABAergic
TTATCCGGAGAGCTAT-1	ForebrainGABAergic
TTATCCGGCGAACGCC-1	Undefined
TTATCCGGCTAAGAGA-1	ForebrainGABAergic
TTATCCGGACTCAATA-1	ForebrainGABAergic
TTATCCGGTCCTACCA-1	Forebrain
TTATCCGGGGCTGAGC-1	Undefined
TTATCCGGACGGAGGC-1	MixedregionGABAergic
TTATCCGGTAGATCTA-1	MixedregionGABAergic
TTATCCGGAATTAAGA-1	MixedregionGABAergic
TTATCCGGTTATTCAT-1	MixedregionGABAergic
TTATCCGGTGCCGGCA-1	Forebrainglutamatergic
TTATCCGGTTACCGAG-1	Corticalorhippocampalglutamatergic
TTATCCGGATCATATT-1	MixedregionGABAergic
TTATCCGGTGGTCAGC-1	Undefined
TTATCCGGACTATGCA-1	Mixedregionglutamatergic
TTATCCGGCGACGCGA-1	MixedregionGABAergic
TTATCCGGCCGATTCC-1	MixedregionGABAergic
TTATCCGGGATACGGA-1	MixedregionGABAergic
TTATCCGGACCGCCAA-1	Forebrainglutamatergic
TTATCCGGCCAGTTCC-1	Undefined
TTATCCGGACTTAACC-1	Undefined
TTATCCGGCAACCGCT-1	Forebrainglutamatergic
TTATCCGGGACCTTGA-1	Forebrainglutamatergic
GATACGGAATAAGGAG-1	MixedregionGABAergic
GATACGGATAGAGTAA-1	ForebrainGABAergic
GATACGGAGCAGGTCC-1	ForebrainGABAergic
GATACGGATCGGCCTT-1	ForebrainGABAergic
GATACGGAAGAACGTC-1	ForebrainGABAergic
GATACGGACTTGCGCC-1	ForebrainGABAergic
GATACGGAGGTACTGC-1	ForebrainGABAergic
GATACGGATAGAATTA-1	ForebrainGABAergic
GATACGGAGCCATTCT-1	ForebrainGABAergic
GATACGGATTGACTTC-1	ForebrainGABAergic
GATACGGAAGAGCTAT-1	ForebrainGABAergic
GATACGGACGAACGCC-1	Undefined
GATACGGACTAAGAGA-1	ForebrainGABAergic
GATACGGAACTCAATA-1	ForebrainGABAergic
GATACGGATCCTACCA-1	ForebrainGABAergic
GATACGGAGCGTTGGA-1	Undefined
GATACGGAGGCTGAGC-1	Forebrainglutamatergic
GATACGGAAATTAAGA-1	Mixedregionglutamatergic
GATACGGATTATTCAT-1	MixedregionGABAergic
GATACGGATGCCGGCA-1	Undefined
GATACGGATTACCGAG-1	Forebrainglutamatergic
GATACGGAATCATATT-1	Corticalorhippocampalglutamatergic
GATACGGATGGTCAGC-1	Undefined
GATACGGAACTATGCA-1	Undefined
GATACGGACGACGCGA-1	Undefined
GATACGGACCGATTCC-1	Midbrainglutamatergic
GATACGGAGATACGGA-1	MixedregionGABAergic
GATACGGATTATCCGG-1	MixedregionGABAergic
GATACGGAACCGCCAA-1	Mixedregionglutamatergic
GATACGGACCAGTTCC-1	MixedregionGABAergic
GATACGGAACTTAACC-1	MixedregionGABAergic
GATACGGACAACCGCT-1	Forebrainglutamatergic
GATACGGAGACCTTGA-1	ForebrainGABAergic
CGACGCGAATAAGGAG-1	MixedregionGABAergic
CGACGCGATAGAGTAA-1	Mixedregionandneurotransmitter
CGACGCGAGCAGGTCC-1	Mixedregionglutamatergic
CGACGCGATCGGCCTT-1	ForebrainGABAergic
CGACGCGAAGAACGTC-1	ForebrainGABAergic
CGACGCGACTTGCGCC-1	ForebrainGABAergic
CGACGCGAGGTACTGC-1	ForebrainGABAergic
CGACGCGATAGAATTA-1	ForebrainGABAergic
CGACGCGAGCCATTCT-1	ForebrainGABAergic
CGACGCGATTGACTTC-1	ForebrainGABAergic
CGACGCGAAGAGCTAT-1	ForebrainGABAergic
CGACGCGACGAACGCC-1	Mixedregionglutamatergic
CGACGCGACTAAGAGA-1	ForebrainGABAergic
CGACGCGAACTCAATA-1	ForebrainGABAergic
CGACGCGATCCTACCA-1	ForebrainGABAergic
CGACGCGAGCGTTGGA-1	ForebrainGABAergic
CGACGCGAGATCTTAC-1	MixedregionGABAergic
CGACGCGACTGATGGT-1	MixedregionGABAergic
CGACGCGACCGAGAAT-1	MixedregionGABAergic
CGACGCGAGCCGCAAC-1	MixedregionGABAergic
CGACGCGATGAGTCTG-1	Undefined
CGACGCGATGCGGACC-1	MixedregionGABAergic
CGACGCGAGGCTGAGC-1	Undefined
CGACGCGAACGGAGGC-1	Mixedregionglutamatergic
CGACGCGATAGATCTA-1	MixedregionGABAergic
CGACGCGAAATTAAGA-1	Undefined
CGACGCGATTATTCAT-1	Mixedregionglutamatergic
CGACGCGATGCCGGCA-1	Undefined
CGACGCGATTACCGAG-1	Undefined
CGACGCGAATCATATT-1	MixedregionGABAergic
CGACGCGATGGTCAGC-1	MixedregionGABAergic
CGACGCGAACTATGCA-1	Undefined
CGACGCGACGACGCGA-1	Undefined
CGACGCGACCGATTCC-1	Undefined
CGACGCGAGATACGGA-1	Undefined
CGACGCGATTATCCGG-1	MixedregionGABAergic
CGACGCGATCTGATAC-1	MixedregionGABAergic
CGACGCGAACCGCCAA-1	Mixedregionglutamatergic
CGACGCGACCAGTTCC-1	MixedregionGABAergic
CGACGCGAACTTAACC-1	MixedregionGABAergic
CGACGCGACAACCGCT-1	Undefined
CGACGCGAGACCTTGA-1	Forebrainglutamatergic
ACTATGCAATAAGGAG-1	ForebrainGABAergic
ACTATGCATAGAGTAA-1	ForebrainGABAergic
ACTATGCAGCAGGTCC-1	ForebrainGABAergic
ACTATGCATCGGCCTT-1	Forebrainglutamatergic
ACTATGCAAGAACGTC-1	Undefined
ACTATGCACTTGCGCC-1	Hindbrainglycinergic
ACTATGCAGGTACTGC-1	MixedregionGABAergic
ACTATGCATAGAATTA-1	ForebrainGABAergic
ACTATGCAGCCATTCT-1	Undefined
ACTATGCATTGACTTC-1	ForebrainGABAergic
ACTATGCAAGAGCTAT-1	ForebrainGABAergic
ACTATGCACGAACGCC-1	Undefined
ACTATGCACTAAGAGA-1	Mixedregionglutamatergic
ACTATGCAACTCAATA-1	Mixedregionglutamatergic
ACTATGCATCCTACCA-1	MixedregionGABAergic
ACTATGCAGCGTTGGA-1	MixedregionGABAergic
ACTATGCAGATCTTAC-1	MixedregionGABAergic
ACTATGCACTGATGGT-1	Undefined
ACTATGCACCGAGAAT-1	Forebrainglutamatergic
ACTATGCAGCCGCAAC-1	Forebrainglutamatergic
ACTATGCATGAGTCTG-1	Corticalorhippocampalglutamatergic
ACTATGCATGCGGACC-1	Forebrainglutamatergic
ACTATGCAGGCTGAGC-1	Undefined
ACTATGCAACGGAGGC-1	Forebrainglutamatergic
ACTATGCATAGATCTA-1	Forebrainglutamatergic
ACTATGCAAATTAAGA-1	MixedregionGABAergic
ACTATGCATTATTCAT-1	MixedregionGABAergic
ACTATGCATGCCGGCA-1	MixedregionGABAergic
ACTATGCATTACCGAG-1	MixedregionGABAergic
ACTATGCAATCATATT-1	Mixedregionglutamatergic
ACTATGCATGGTCAGC-1	MixedregionGABAergic
ACTATGCAACTATGCA-1	Undefined
ACTATGCACGACGCGA-1	Mixedregionandneurotransmitter
ACTATGCACCGATTCC-1	Mixedregionglutamatergic
ACTATGCAGATACGGA-1	MixedregionGABAergic
ACTATGCATTATCCGG-1	Undefined
ACTATGCATCTGATAC-1	Mixedregionglutamatergic
ACTATGCAGAAGATCG-1	Forebrainglutamatergic
ACTATGCAAAGAAGCT-1	MidbrainGABAergic
ACTATGCAACCGCCAA-1	Pia3
ACTATGCACCAGTTCC-1	MixedregionGABAergic
ACTATGCAACTTAACC-1	MixedregionGABAergic
ACTATGCACAACCGCT-1	Undefined
ACTATGCAGACCTTGA-1	ForebrainGABAergic
TGGTCAGCATAAGGAG-1	Mixedregionglutamatergic
TGGTCAGCTAGAGTAA-1	Undefined
TGGTCAGCGCAGGTCC-1	ForebrainGABAergic
TGGTCAGCTCGGCCTT-1	MixedregionGABAergic
TGGTCAGCAGAACGTC-1	Mixedregionandneurotransmitter
TGGTCAGCCTTGCGCC-1	Undefined
TGGTCAGCGGTACTGC-1	Mixedregionglutamatergic
TGGTCAGCTAGAATTA-1	Mixedregionglutamatergic
TGGTCAGCGCCATTCT-1	Undefined
TGGTCAGCTTGACTTC-1	ForebrainGABAergic
TGGTCAGCAGAGCTAT-1	Mixedregionglutamatergic
TGGTCAGCCGAACGCC-1	MixedregionGABAergic
TGGTCAGCCTAAGAGA-1	MixedregionGABAergic
TGGTCAGCACTCAATA-1	Undefined
TGGTCAGCTCCTACCA-1	Mixedregionglutamatergic
TGGTCAGCGCGTTGGA-1	Forebrainglutamatergic
TGGTCAGCGATCTTAC-1	Forebrainglutamatergic
TGGTCAGCCTGATGGT-1	Forebrainglutamatergic
TGGTCAGCCCGAGAAT-1	Forebrainglutamatergic
TGGTCAGCGCCGCAAC-1	MixedregionGABAergic
TGGTCAGCTGAGTCTG-1	Mixedregionglutamatergic
TGGTCAGCTGCGGACC-1	Corticalorhippocampalglutamatergic
TGGTCAGCGGCTGAGC-1	Undefined
TGGTCAGCACGGAGGC-1	Corticalorhippocampalglutamatergic
TGGTCAGCTAGATCTA-1	MixedregionGABAergic
TGGTCAGCAATTAAGA-1	Corticalorhippocampalglutamatergic
TGGTCAGCTTATTCAT-1	Corticalorhippocampalglutamatergic
TGGTCAGCTGCCGGCA-1	Corticalorhippocampalglutamatergic
TGGTCAGCTTACCGAG-1	Corticalorhippocampalglutamatergic
TGGTCAGCATCATATT-1	Mixedregionglutamatergic
TGGTCAGCTGGTCAGC-1	Undefined
TGGTCAGCACTATGCA-1	Undefined
TGGTCAGCCGACGCGA-1	Mixedregionglutamatergic
TGGTCAGCCCGATTCC-1	Undefined
TGGTCAGCGATACGGA-1	MixedregionGABAergic
TGGTCAGCTTATCCGG-1	MixedregionGABAergic
TGGTCAGCTCTGATAC-1	Undefined
TGGTCAGCGAAGATCG-1	Forebrainglutamatergic
TGGTCAGCAAGAAGCT-1	Mixedregionglutamatergic
TGGTCAGCACCGCCAA-1	Undefined
TGGTCAGCCCAGTTCC-1	Undefined
TGGTCAGCACTTAACC-1	MixedregionGABAergic
TGGTCAGCCAACCGCT-1	MixedregionGABAergic
TGGTCAGCGACCTTGA-1	MixedregionGABAergic
ATCATATTATAAGGAG-1	ForebrainGABAergic
ATCATATTTAGAGTAA-1	Undefined
ATCATATTGCAGGTCC-1	Undefined
ATCATATTTCGGCCTT-1	Mixedregionandneurotransmitter
ATCATATTAGAACGTC-1	Mixedregionandneurotransmitter
ATCATATTCTTGCGCC-1	Undefined
ATCATATTGGTACTGC-1	Mixedregionglutamatergic
ATCATATTTAGAATTA-1	ForebrainGABAergic
ATCATATTGCCATTCT-1	ForebrainGABAergic
ATCATATTTTGACTTC-1	ForebrainGABAergic
ATCATATTAGAGCTAT-1	ForebrainGABAergic
ATCATATTCGAACGCC-1	Midbrainglutamatergic
ATCATATTCTAAGAGA-1	ForebrainGABAergic
ATCATATTACTCAATA-1	ForebrainGABAergic
ATCATATTTCCTACCA-1	MixedregionGABAergic
ATCATATTGCGTTGGA-1	MixedregionGABAergic
ATCATATTGATCTTAC-1	Mixedregionglutamatergic
ATCATATTCTGATGGT-1	Mixedregionglutamatergic
ATCATATTCCGAGAAT-1	Mixedregionglutamatergic
ATCATATTGCCGCAAC-1	Mixedregionglutamatergic
ATCATATTTGAGTCTG-1	Mixedregionglutamatergic
ATCATATTTGCGGACC-1	Mixedregionglutamatergic
ATCATATTGGCTGAGC-1	Mixedregionglutamatergic
ATCATATTACGGAGGC-1	Mixedregionglutamatergic
ATCATATTTAGATCTA-1	Mixedregionglutamatergic
ATCATATTAATTAAGA-1	MixedregionGABAergic
ATCATATTTTATTCAT-1	Mixedregionglutamatergic
ATCATATTTGCCGGCA-1	MixedregionGABAergic
ATCATATTTTACCGAG-1	Mixedregionglutamatergic
ATCATATTATCATATT-1	Undefined
ATCATATTTGGTCAGC-1	MixedregionGABAergic
ATCATATTACTATGCA-1	MixedregionGABAergic
ATCATATTCGACGCGA-1	MixedregionGABAergic
ATCATATTCCGATTCC-1	Forebrainglutamatergic
ATCATATTGATACGGA-1	MixedregionGABAergic
ATCATATTTTATCCGG-1	MixedregionGABAergic
ATCATATTTCTGATAC-1	Undefined
ATCATATTGAAGATCG-1	Undefined
ATCATATTAAGAAGCT-1	Undefined
ATCATATTTCCGGCCT-1	Forebrainglutamatergic
ATCATATTACCGCCAA-1	Undefined
ATCATATTCCAGTTCC-1	Mixedregionglutamatergic
ATCATATTACTTAACC-1	MixedregionGABAergic
ATCATATTCAACCGCT-1	MixedregionGABAergic
ATCATATTGACCTTGA-1	Undefined
TTACCGAGATAAGGAG-1	Mixedregion
TTACCGAGTAGAGTAA-1	Mixedregionglutamatergic
TTACCGAGGCAGGTCC-1	Corticalorhippocampalglutamatergic
TTACCGAGTCGGCCTT-1	Undefined
TTACCGAGAGAACGTC-1	MixedregionGABAergic
TTACCGAGCTTGCGCC-1	ForebrainGABAergic
TTACCGAGGGTACTGC-1	MixedregionGABAergic
TTACCGAGTAGAATTA-1	ForebrainGABAergic
TTACCGAGGCCATTCT-1	ForebrainGABAergic
TTACCGAGTTGACTTC-1	ForebrainGABAergic
TTACCGAGAGAGCTAT-1	ForebrainGABAergic
TTACCGAGCGAACGCC-1	Undefined
TTACCGAGCTAAGAGA-1	ForebrainGABAergic
TTACCGAGACTCAATA-1	MixedregionGABAergic
TTACCGAGTCCTACCA-1	MixedregionGABAergic
TTACCGAGGCGTTGGA-1	Undefined
TTACCGAGGATCTTAC-1	Mixedregionglutamatergic
TTACCGAGCTGATGGT-1	Mixedregionglutamatergic
TTACCGAGCCGAGAAT-1	Mixedregionglutamatergic
TTACCGAGGCCGCAAC-1	Mixedregionglutamatergic
TTACCGAGTGAGTCTG-1	Mixedregionglutamatergic
TTACCGAGTGCGGACC-1	MixedregionGABAergic
TTACCGAGGGCTGAGC-1	Undefined
TTACCGAGACGGAGGC-1	MixedregionGABAergic
TTACCGAGTAGATCTA-1	Mixedregionglutamatergic
TTACCGAGAATTAAGA-1	MixedregionGABAergic
TTACCGAGTTATTCAT-1	MixedregionGABAergic
TTACCGAGTGCCGGCA-1	MixedregionGABAergic
TTACCGAGTTACCGAG-1	MixedregionGABAergic
TTACCGAGATCATATT-1	MixedregionGABAergic
TTACCGAGTGGTCAGC-1	MixedregionGABAergic
TTACCGAGACTATGCA-1	Undefined
TTACCGAGCGACGCGA-1	MixedregionGABAergic
TTACCGAGCCGATTCC-1	Undefined
TTACCGAGGATACGGA-1	MixedregionGABAergic
TTACCGAGTTATCCGG-1	MixedregionGABAergic
TTACCGAGTCTGATAC-1	Undefined
TTACCGAGGAAGATCG-1	Mixedregionglutamatergic
TTACCGAGAAGAAGCT-1	Undefined
TTACCGAGTCCGGCCT-1	Forebrainglutamatergic
TTACCGAGAGAGAAGG-1	MixedregionGABAergic
TTACCGAGACCGCCAA-1	Undefined
TTACCGAGCCAGTTCC-1	Undefined
TTACCGAGACTTAACC-1	Mixedregionandneurotransmitter
TTACCGAGCAACCGCT-1	MixedregionGABAergic
TTACCGAGGACCTTGA-1	MixedregionGABAergic
TGCCGGCAATAAGGAG-1	Mixedregion
TGCCGGCATAGAGTAA-1	Undefined
TGCCGGCAGCAGGTCC-1	Midbrainglutamatergic
TGCCGGCATCGGCCTT-1	Undefined
TGCCGGCAAGAACGTC-1	Forebrainglutamatergic
TGCCGGCACTTGCGCC-1	MixedregionGABAergic
TGCCGGCAGGTACTGC-1	MixedregionGABAergic
TGCCGGCATAGAATTA-1	ForebrainGABAergic
TGCCGGCAGCCATTCT-1	Mixedregionglutamatergic
TGCCGGCATTGACTTC-1	ForebrainGABAergic
TGCCGGCAAGAGCTAT-1	ForebrainGABAergic
TGCCGGCACGAACGCC-1	Mixedregionglutamatergic
TGCCGGCACTAAGAGA-1	Mixedregionglutamatergic
TGCCGGCAACTCAATA-1	Mixedregionglutamatergic
TGCCGGCATCCTACCA-1	MixedregionGABAergic
TGCCGGCAGCGTTGGA-1	Mixedregionglutamatergic
TGCCGGCAGATCTTAC-1	MixedregionGABAergic
TGCCGGCACTGATGGT-1	MixedregionGABAergic
TGCCGGCACCGAGAAT-1	MixedregionGABAergic
TGCCGGCAGCCGCAAC-1	Mixedregionglutamatergic
TGCCGGCATGAGTCTG-1	MixedregionGABAergic
TGCCGGCATGCGGACC-1	MixedregionGABAergic
TGCCGGCAGGCTGAGC-1	Undefined
TGCCGGCAACGGAGGC-1	Mixedregionglutamatergic
TGCCGGCATAGATCTA-1	Mixedregionglutamatergic
TGCCGGCAAATTAAGA-1	MixedregionGABAergic
TGCCGGCATTATTCAT-1	MixedregionGABAergic
TGCCGGCATGCCGGCA-1	MixedregionGABAergic
TGCCGGCATTACCGAG-1	MixedregionGABAergic
TGCCGGCAATCATATT-1	MixedregionGABAergic
TGCCGGCATGGTCAGC-1	MixedregionGABAergic
TGCCGGCAACTATGCA-1	MixedregionGABAergic
TGCCGGCACGACGCGA-1	Mixedregionglutamatergic
TGCCGGCACCGATTCC-1	Undefined
TGCCGGCAGATACGGA-1	MixedregionGABAergic
TGCCGGCATTATCCGG-1	MixedregionGABAergic
TGCCGGCATCTGATAC-1	MixedregionGABAergic
TGCCGGCAGAAGATCG-1	MixedregionGABAergic
TGCCGGCAAAGAAGCT-1	MixedregionGABAergic
TGCCGGCATCCGGCCT-1	Undefined
TGCCGGCAAGAGAAGG-1	Mixedregionglutamatergic
TGCCGGCACATACTCC-1	Undefined
TGCCGGCAACCGCCAA-1	Undefined
TGCCGGCACCAGTTCC-1	Undefined
TGCCGGCAACTTAACC-1	Undefined
TGCCGGCACAACCGCT-1	MixedregionGABAergic
TGCCGGCAGACCTTGA-1	MixedregionGABAergic
TTATTCATATAAGGAG-1	Mixedregionglutamatergic
TTATTCATTAGAGTAA-1	MixedregionGABAergic
TTATTCATGCAGGTCC-1	MixedregionGABAergic
TTATTCATTCGGCCTT-1	Mixedregionandneurotransmitter
TTATTCATAGAACGTC-1	MixedregionGABAergic
TTATTCATCTTGCGCC-1	Mixedregionglutamatergic
TTATTCATGGTACTGC-1	Mixedregionglutamatergic
TTATTCATTAGAATTA-1	ForebrainGABAergic
TTATTCATGCCATTCT-1	ForebrainGABAergic
TTATTCATTTGACTTC-1	ForebrainGABAergic
TTATTCATAGAGCTAT-1	ForebrainGABAergic
TTATTCATCGAACGCC-1	Mixedregionglutamatergic
TTATTCATCTAAGAGA-1	Undefined
TTATTCATACTCAATA-1	MixedregionGABAergic
TTATTCATTCCTACCA-1	MixedregionGABAergic
TTATTCATGCGTTGGA-1	Mixedregionglutamatergic
TTATTCATGATCTTAC-1	MixedregionGABAergic
TTATTCATCTGATGGT-1	Mixedregionglutamatergic
TTATTCATCCGAGAAT-1	Mixedregionglutamatergic
TTATTCATGCCGCAAC-1	MixedregionGABAergic
TTATTCATTGAGTCTG-1	MixedregionGABAergic
TTATTCATTGCGGACC-1	MixedregionGABAergic
TTATTCATGGCTGAGC-1	Midbrainglutamatergic
TTATTCATACGGAGGC-1	MixedregionGABAergic
TTATTCATTAGATCTA-1	MixedregionGABAergic
TTATTCATAATTAAGA-1	MixedregionGABAergic
TTATTCATTTATTCAT-1	MixedregionGABAergic
TTATTCATTGCCGGCA-1	MixedregionGABAergic
TTATTCATTTACCGAG-1	MixedregionGABAergic
TTATTCATATCATATT-1	MixedregionGABAergic
TTATTCATTGGTCAGC-1	MixedregionGABAergic
TTATTCATACTATGCA-1	MixedregionGABAergic
TTATTCATCGACGCGA-1	Mixedregionglutamatergic
TTATTCATCCGATTCC-1	Undefined
TTATTCATGATACGGA-1	MixedregionGABAergic
TTATTCATTTATCCGG-1	MixedregionGABAergic
TTATTCATTCTGATAC-1	MixedregionGABAergic
TTATTCATGAAGATCG-1	Mixedregionglutamatergic
TTATTCATAAGAAGCT-1	MixedregionGABAergic
TTATTCATTCCGGCCT-1	MixedregionGABAergic
TTATTCATAGAGAAGG-1	Undefined
TTATTCATCATACTCC-1	MixedregionGABAergic
TTATTCATGCTAACTT-1	Midbrainglutamatergic
TTATTCATACCGCCAA-1	MixedregionGABAergic
TTATTCATCCAGTTCC-1	Undefined
TTATTCATACTTAACC-1	Undefined
TTATTCATCAACCGCT-1	Undefined
TTATTCATGACCTTGA-1	MixedregionGABAergic
AATTAAGAATAAGGAG-1	ForebrainGABAergic
AATTAAGATAGAGTAA-1	MixedregionGABAergic
AATTAAGAGCAGGTCC-1	MixedregionGABAergic
AATTAAGATCGGCCTT-1	Forebrainglutamatergic
AATTAAGAAGAACGTC-1	Mixedregionandneurotransmitter
AATTAAGACTTGCGCC-1	ForebrainGABAergic
AATTAAGAGGTACTGC-1	MixedregionGABAergic
AATTAAGATAGAATTA-1	MixedregionGABAergic
AATTAAGAGCCATTCT-1	ForebrainGABAergic
AATTAAGATTGACTTC-1	ForebrainGABAergic
AATTAAGAAGAGCTAT-1	ForebrainGABAergic
AATTAAGACGAACGCC-1	Hypothalamus
AATTAAGACTAAGAGA-1	Undefined
AATTAAGAACTCAATA-1	MixedregionGABAergic
AATTAAGATCCTACCA-1	MixedregionGABAergic
AATTAAGAGCGTTGGA-1	MixedregionGABAergic
AATTAAGAGATCTTAC-1	Mixedregionglutamatergic
AATTAAGACTGATGGT-1	MixedregionGABAergic
AATTAAGACCGAGAAT-1	Mixedregionglutamatergic
AATTAAGAGCCGCAAC-1	MixedregionGABAergic
AATTAAGATGAGTCTG-1	MixedregionGABAergic
AATTAAGATGCGGACC-1	MixedregionGABAergic
AATTAAGAGGCTGAGC-1	MixedregionGABAergic
AATTAAGAACGGAGGC-1	MixedregionGABAergic
AATTAAGATAGATCTA-1	MixedregionGABAergic
AATTAAGAAATTAAGA-1	MixedregionGABAergic
AATTAAGATTATTCAT-1	MixedregionGABAergic
AATTAAGATGCCGGCA-1	MixedregionGABAergic
AATTAAGATTACCGAG-1	MixedregionGABAergic
AATTAAGAATCATATT-1	MixedregionGABAergic
AATTAAGATGGTCAGC-1	MixedregionGABAergic
AATTAAGAACTATGCA-1	Mixedregionglutamatergic
AATTAAGACGACGCGA-1	Mixedregionglutamatergic
AATTAAGACCGATTCC-1	Undefined
AATTAAGAGATACGGA-1	MixedregionGABAergic
AATTAAGATTATCCGG-1	MixedregionGABAergic
AATTAAGATCTGATAC-1	MixedregionGABAergic
AATTAAGAGAAGATCG-1	MixedregionGABAergic
AATTAAGAAAGAAGCT-1	MixedregionGABAergic
AATTAAGATCCGGCCT-1	MixedregionGABAergic
AATTAAGAAGAGAAGG-1	MixedregionGABAergic
AATTAAGACATACTCC-1	Undefined
AATTAAGAGCTAACTT-1	Undefined
AATTAAGAGGTATGCT-1	Mixedregionandneurotransmitter
AATTAAGAACCGCCAA-1	Undefined
AATTAAGACCAGTTCC-1	Undefined
AATTAAGAACTTAACC-1	Undefined
AATTAAGACAACCGCT-1	Undefined
AATTAAGAGACCTTGA-1	Mixedregionglutamatergic
AACCTGCGGCAGGTCC-1	Undefined
AACCTGCGTCGGCCTT-1	Undefined
AACCTGCGAGAACGTC-1	MixedregionGABAergic
AACCTGCGCTTGCGCC-1	Mixedregionglutamatergic
AACCTGCGGGTACTGC-1	Undefined
AACCTGCGTAGAATTA-1	Undefined
AACCTGCGGCCATTCT-1	Corticalorhippocampalglutamatergic
AACCTGCGTTGACTTC-1	Undefined
AACCTGCGAGAGCTAT-1	ForebrainGABAergic
AACCTGCGCTAAGAGA-1	Mixedregionglutamatergic
AACCTGCGACTCAATA-1	Undefined
AACCTGCGTCCTACCA-1	Mixedregionglutamatergic
AACCTGCGGCGTTGGA-1	MixedregionGABAergic
AACCTGCGGATCTTAC-1	MixedregionGABAergic
AACCTGCGCTGATGGT-1	Mixedregionglutamatergic
AACCTGCGCCGAGAAT-1	MixedregionGABAergic
TAGATCTAATAAGGAG-1	Undefined
TAGATCTATAGAGTAA-1	MixedregionGABAergic
TAGATCTAGCAGGTCC-1	MixedregionGABAergic
TAGATCTATCGGCCTT-1	MixedregionGABAergic
TAGATCTAAGAACGTC-1	MixedregionGABAergic
TAGATCTACTTGCGCC-1	MixedregionGABAergic
TAGATCTAGGTACTGC-1	MixedregionGABAergic
TAGATCTATAGAATTA-1	MixedregionGABAergic
TAGATCTAGCCATTCT-1	MixedregionGABAergic
TAGATCTATTGACTTC-1	MixedregionGABAergic
TAGATCTAAGAGCTAT-1	MixedregionGABAergic
TAGATCTACGAACGCC-1	Undefined
TAGATCTACTAAGAGA-1	MixedregionGABAergic
TAGATCTAACTCAATA-1	MixedregionGABAergic
TAGATCTATCCTACCA-1	MixedregionGABAergic
TAGATCTAGCGTTGGA-1	MixedregionGABAergic
TAGATCTAGATCTTAC-1	MixedregionGABAergic
TAGATCTACTGATGGT-1	Mixedregionglutamatergic
TAGATCTACCGAGAAT-1	MixedregionGABAergic
TAGATCTAGCCGCAAC-1	MixedregionGABAergic
TAGATCTATGAGTCTG-1	Mixedregionglutamatergic
TAGATCTATGCGGACC-1	MixedregionGABAergic
TAGATCTAGGCTGAGC-1	Mixedregionglutamatergic
TAGATCTAACGGAGGC-1	Mixedregionglutamatergic
TAGATCTATAGATCTA-1	MixedregionGABAergic
TAGATCTAAATTAAGA-1	MixedregionGABAergic
TAGATCTATTATTCAT-1	MixedregionGABAergic
TAGATCTATGCCGGCA-1	MixedregionGABAergic
TAGATCTATTACCGAG-1	MixedregionGABAergic
TAGATCTAATCATATT-1	MixedregionGABAergic
TAGATCTATGGTCAGC-1	Mixedregionglutamatergic
TAGATCTAACTATGCA-1	Mixedregionglutamatergic
TAGATCTACGACGCGA-1	Mixedregionglutamatergic
TAGATCTACCGATTCC-1	Undefined
TAGATCTAGATACGGA-1	MixedregionGABAergic
TAGATCTATTATCCGG-1	MixedregionGABAergic
TAGATCTATCTGATAC-1	MixedregionGABAergic
TAGATCTAGAAGATCG-1	MixedregionGABAergic
TAGATCTAAAGAAGCT-1	MixedregionGABAergic
TAGATCTATCCGGCCT-1	MixedregionGABAergic
TAGATCTAAGAGAAGG-1	MixedregionGABAergic
TAGATCTACATACTCC-1	MidbrainGABAergic
TAGATCTAGCTAACTT-1	Undefined
TAGATCTAGGTATGCT-1	Mixedregionglutamatergic
TAGATCTAACCGCCAA-1	Undefined
TAGATCTAAACCTGCG-1	MixedregionGABAergic
TAGATCTACCAGTTCC-1	Mixedregionglutamatergic
TAGATCTAACTTAACC-1	Mixedregionglutamatergic
TAGATCTACAACCGCT-1	Mixedregionglutamatergic
TAGATCTAGACCTTGA-1	Mixedregionglutamatergic
ACGGAGGCATAAGGAG-1	ForebrainGABAergic
ACGGAGGCTAGAGTAA-1	MixedregionGABAergic
ACGGAGGCGCAGGTCC-1	MixedregionGABAergic
ACGGAGGCTCGGCCTT-1	MixedregionGABAergic
ACGGAGGCAGAACGTC-1	MixedregionGABAergic
ACGGAGGCCTTGCGCC-1	MixedregionGABAergic
ACGGAGGCGGTACTGC-1	MixedregionGABAergic
ACGGAGGCTAGAATTA-1	Mixedregionglutamatergic
ACGGAGGCGCCATTCT-1	MixedregionGABAergic
ACGGAGGCTTGACTTC-1	MixedregionGABAergic
ACGGAGGCAGAGCTAT-1	MixedregionGABAergic
ACGGAGGCCGAACGCC-1	Mixedregionglutamatergic
ACGGAGGCCTAAGAGA-1	Mixedregionglutamatergic
ACGGAGGCACTCAATA-1	MixedregionGABAergic
ACGGAGGCTCCTACCA-1	MixedregionGABAergic
ACGGAGGCGCGTTGGA-1	MixedregionGABAergic
ACGGAGGCGATCTTAC-1	MixedregionGABAergic
ACGGAGGCCTGATGGT-1	Mixedregionglutamatergic
ACGGAGGCCCGAGAAT-1	MixedregionGABAergic
ACGGAGGCGCCGCAAC-1	MixedregionGABAergic
ACGGAGGCTGAGTCTG-1	MixedregionGABAergic
ACGGAGGCTGCGGACC-1	MixedregionGABAergic
ACGGAGGCGGCTGAGC-1	Undefined
ACGGAGGCACGGAGGC-1	MixedregionGABAergic
ACGGAGGCTAGATCTA-1	MixedregionGABAergic
ACGGAGGCAATTAAGA-1	MixedregionGABAergic
ACGGAGGCTTATTCAT-1	Mixedregionglutamatergic
ACGGAGGCTGCCGGCA-1	MixedregionGABAergic
ACGGAGGCTTACCGAG-1	MixedregionGABAergic
ACGGAGGCATCATATT-1	MixedregionGABAergic
ACGGAGGCTGGTCAGC-1	MixedregionGABAergic
ACGGAGGCACTATGCA-1	MixedregionGABAergic
ACGGAGGCCGACGCGA-1	Mixedregionglutamatergic
ACGGAGGCCCGATTCC-1	MixedregionGABAergic
ACGGAGGCGATACGGA-1	MixedregionGABAergic
ACGGAGGCTTATCCGG-1	Mixedregionglutamatergic
ACGGAGGCTCTGATAC-1	Mixedregionglutamatergic
ACGGAGGCGAAGATCG-1	MixedregionGABAergic
ACGGAGGCAAGAAGCT-1	MixedregionGABAergic
ACGGAGGCTCCGGCCT-1	MixedregionGABAergic
ACGGAGGCAGAGAAGG-1	Mixedregionglutamatergic
ACGGAGGCCATACTCC-1	MidbrainGABAergic
ACGGAGGCGCTAACTT-1	Mixedregionglutamatergic
ACGGAGGCGGTATGCT-1	MixedregionGABAergic
ACGGAGGCACCGCCAA-1	Undefined
ACGGAGGCAACCTGCG-1	Mixedregionglutamatergic
ACGGAGGCCCAGTTCC-1	Undefined
ACGGAGGCACTTAACC-1	Mixedregionglutamatergic
ACGGAGGCCAACCGCT-1	Mixedregionglutamatergic
ACGGAGGCGACCTTGA-1	Undefined
TGCGGACCATAAGGAG-1	Undefined
TGCGGACCTAGAGTAA-1	Forebrainglutamatergic
TGCGGACCGCAGGTCC-1	Undefined
TGCGGACCTCGGCCTT-1	MixedregionGABAergic
TGCGGACCAGAACGTC-1	MixedregionGABAergic
TGCGGACCCTTGCGCC-1	MixedregionGABAergic
TGCGGACCGGTACTGC-1	MixedregionGABAergic
TGCGGACCTAGAATTA-1	MixedregionGABAergic
TGCGGACCGCCATTCT-1	MixedregionGABAergic
TGCGGACCTTGACTTC-1	MixedregionGABAergic
TGCGGACCAGAGCTAT-1	MixedregionGABAergic
TGCGGACCCGAACGCC-1	Undefined
TGCGGACCCTAAGAGA-1	Mixedregionglutamatergic
TGCGGACCACTCAATA-1	MixedregionGABAergic
TGCGGACCTCCTACCA-1	MixedregionGABAergic
TGCGGACCGCGTTGGA-1	MixedregionGABAergic
TGCGGACCGATCTTAC-1	Mixedregionglutamatergic
TGCGGACCCTGATGGT-1	MixedregionGABAergic
TGCGGACCCCGAGAAT-1	MixedregionGABAergic
TGCGGACCGCCGCAAC-1	MixedregionGABAergic
TGCGGACCTGAGTCTG-1	Mixedregionglutamatergic
TGCGGACCTGCGGACC-1	Mixedregionglutamatergic
TGCGGACCGGCTGAGC-1	MixedregionGABAergic
TGCGGACCACGGAGGC-1	MixedregionGABAergic
TGCGGACCTAGATCTA-1	Mixedregionglutamatergic
TGCGGACCAATTAAGA-1	MixedregionGABAergic
TGCGGACCTTATTCAT-1	MixedregionGABAergic
TGCGGACCTGCCGGCA-1	MixedregionGABAergic
TGCGGACCTTACCGAG-1	MixedregionGABAergic
TGCGGACCATCATATT-1	Mixedregionglutamatergic
TGCGGACCTGGTCAGC-1	Mixedregionglutamatergic
TGCGGACCACTATGCA-1	MixedregionGABAergic
TGCGGACCCGACGCGA-1	Mixedregionglutamatergic
TGCGGACCCCGATTCC-1	Undefined
TGCGGACCGATACGGA-1	MixedregionGABAergic
TGCGGACCTTATCCGG-1	MixedregionGABAergic
TGCGGACCGAAGATCG-1	Mixedregionglutamatergic
TGCGGACCAAGAAGCT-1	Mixedregionglutamatergic
TGCGGACCTCCGGCCT-1	Mixedregionglutamatergic
TGCGGACCAGAGAAGG-1	Undefined
TGCGGACCCATACTCC-1	MixedregionGABAergic
TGCGGACCGCTAACTT-1	Mixedregionglutamatergic
TGCGGACCGGTATGCT-1	Undefined
TGCGGACCACCGCCAA-1	MixedregionGABAergic
TGCGGACCAACCTGCG-1	MixedregionGABAergic
TGCGGACCCCAGTTCC-1	Undefined
TGCGGACCACTTAACC-1	Undefined
TGCGGACCCAACCGCT-1	MixedregionGABAergic
TGCGGACCGACCTTGA-1	MixedregionGABAergic
TGAGTCTGATAAGGAG-1	MixedregionGABAergic
TGAGTCTGTAGAGTAA-1	Undefined
TGAGTCTGGCAGGTCC-1	MixedregionGABAergic
TGAGTCTGTCGGCCTT-1	MixedregionGABAergic
TGAGTCTGAGAACGTC-1	MixedregionGABAergic
TGAGTCTGCTTGCGCC-1	MixedregionGABAergic
TGAGTCTGGGTACTGC-1	MixedregionGABAergic
TGAGTCTGTAGAATTA-1	MixedregionGABAergic
TGAGTCTGGCCATTCT-1	MixedregionGABAergic
TGAGTCTGTTGACTTC-1	Mixedregionglutamatergic
TGAGTCTGAGAGCTAT-1	MixedregionGABAergic
TGAGTCTGCGAACGCC-1	MixedregionGABAergic
TGAGTCTGCTAAGAGA-1	MixedregionGABAergic
TGAGTCTGACTCAATA-1	MixedregionGABAergic
TGAGTCTGTCCTACCA-1	MixedregionGABAergic
TGAGTCTGGCGTTGGA-1	MixedregionGABAergic
TGAGTCTGGATCTTAC-1	MixedregionGABAergic
TGAGTCTGCTGATGGT-1	MixedregionGABAergic
TGAGTCTGCCGAGAAT-1	MixedregionGABAergic
TGAGTCTGGCCGCAAC-1	MixedregionGABAergic
TGAGTCTGTGAGTCTG-1	MixedregionGABAergic
TGAGTCTGTGCGGACC-1	MixedregionGABAergic
TGAGTCTGGGCTGAGC-1	Undefined
TGAGTCTGACGGAGGC-1	MixedregionGABAergic
TGAGTCTGTAGATCTA-1	MixedregionGABAergic
TGAGTCTGAATTAAGA-1	MixedregionGABAergic
TGAGTCTGTTATTCAT-1	Mixedregionglutamatergic
TGAGTCTGTGCCGGCA-1	Mixedregionglutamatergic
TGAGTCTGTTACCGAG-1	MixedregionGABAergic
TGAGTCTGATCATATT-1	MixedregionGABAergic
TGAGTCTGTGGTCAGC-1	MixedregionGABAergic
TGAGTCTGACTATGCA-1	Undefined
TGAGTCTGCGACGCGA-1	Mixedregionglutamatergic
TGAGTCTGCCGATTCC-1	Undefined
TGAGTCTGGATACGGA-1	MixedregionGABAergic
TGAGTCTGTTATCCGG-1	Mixedregionglutamatergic
TGAGTCTGTCTGATAC-1	MixedregionGABAergic
TGAGTCTGAAGAAGCT-1	Mixedregionglutamatergic
TGAGTCTGTCCGGCCT-1	ForebrainGABAergic
TGAGTCTGAGAGAAGG-1	MixedregionGABAergic
TGAGTCTGCATACTCC-1	Mixedregionglutamatergic
TGAGTCTGGCTAACTT-1	Mixedregionglutamatergic
TGAGTCTGGGTATGCT-1	Mixedregionglutamatergic
TGAGTCTGACCGCCAA-1	MixedregionGABAergic
TGAGTCTGAACCTGCG-1	Undefined
TGAGTCTGCCAGTTCC-1	Undefined
TGAGTCTGACTTAACC-1	MixedregionGABAergic
TGAGTCTGCAACCGCT-1	MixedregionGABAergic
TGAGTCTGGACCTTGA-1	Undefined
GCCGCAACATAAGGAG-1	Corticalorhippocampalglutamatergic
GCCGCAACTAGAGTAA-1	Undefined
GCCGCAACGCAGGTCC-1	Mixedregionandneurotransmitter
GCCGCAACTCGGCCTT-1	Mixedregionglutamatergic
GCCGCAACAGAACGTC-1	MixedregionGABAergic
GCCGCAACCTTGCGCC-1	MixedregionGABAergic
GCCGCAACGGTACTGC-1	MixedregionGABAergic
GCCGCAACTAGAATTA-1	MixedregionGABAergic
GCCGCAACGCCATTCT-1	MixedregionGABAergic
GCCGCAACTTGACTTC-1	MixedregionGABAergic
GCCGCAACAGAGCTAT-1	MixedregionGABAergic
GCCGCAACCGAACGCC-1	Mixedregionglutamatergic
GCCGCAACCTAAGAGA-1	Mixedregionglutamatergic
GCCGCAACACTCAATA-1	MixedregionGABAergic
GCCGCAACTCCTACCA-1	MixedregionGABAergic
GCCGCAACGCGTTGGA-1	MixedregionGABAergic
GCCGCAACGATCTTAC-1	MixedregionGABAergic
GCCGCAACCTGATGGT-1	MixedregionGABAergic
GCCGCAACCCGAGAAT-1	MixedregionGABAergic
GCCGCAACGCCGCAAC-1	MixedregionGABAergic
GCCGCAACTGAGTCTG-1	MixedregionGABAergic
GCCGCAACTGCGGACC-1	MixedregionGABAergic
GCCGCAACGGCTGAGC-1	MixedregionGABAergic
GCCGCAACACGGAGGC-1	MixedregionGABAergic
GCCGCAACTAGATCTA-1	Mixedregionglutamatergic
GCCGCAACAATTAAGA-1	MixedregionGABAergic
GCCGCAACTTATTCAT-1	Mixedregionglutamatergic
GCCGCAACTGCCGGCA-1	Mixedregionglutamatergic
GCCGCAACTTACCGAG-1	Mixedregionglutamatergic
GCCGCAACATCATATT-1	MixedregionGABAergic
GCCGCAACTGGTCAGC-1	MixedregionGABAergic
GCCGCAACACTATGCA-1	Mixedregionglutamatergic
GCCGCAACCGACGCGA-1	MixedregionGABAergic
GCCGCAACCCGATTCC-1	Hindbrainglutamatergic
GCCGCAACGATACGGA-1	MixedregionGABAergic
GCCGCAACTTATCCGG-1	MixedregionGABAergic
GCCGCAACAAGAAGCT-1	Midbrain
GCCGCAACTCCGGCCT-1	Undefined
GCCGCAACAGAGAAGG-1	Mixedregionglutamatergic
GCCGCAACCATACTCC-1	MixedregionGABAergic
GCCGCAACGCTAACTT-1	Mixedregionglutamatergic
GCCGCAACGGTATGCT-1	Undefined
GCCGCAACACCGCCAA-1	MixedregionGABAergic
GCCGCAACAACCTGCG-1	MixedregionGABAergic
GCCGCAACCCAGTTCC-1	Undefined
GCCGCAACACTTAACC-1	Undefined
GCCGCAACCAACCGCT-1	Mixedregionglutamatergic
GCCGCAACGACCTTGA-1	Undefined
CCGAGAATATAAGGAG-1	Undefined
CCGAGAATTAGAGTAA-1	Undefined
CCGAGAATGCAGGTCC-1	Mixedregionglutamatergic
CCGAGAATTCGGCCTT-1	Mixedregionglutamatergic
CCGAGAATAGAACGTC-1	MixedregionGABAergic
CCGAGAATCTTGCGCC-1	MixedregionGABAergic
CCGAGAATGGTACTGC-1	MixedregionGABAergic
CCGAGAATTAGAATTA-1	Mixedregionglutamatergic
CCGAGAATGCCATTCT-1	Mixedregionglutamatergic
CCGAGAATTTGACTTC-1	MixedregionGABAergic
CCGAGAATAGAGCTAT-1	MixedregionGABAergic
CCGAGAATCGAACGCC-1	Undefined
CCGAGAATCTAAGAGA-1	MixedregionGABAergic
CCGAGAATACTCAATA-1	MixedregionGABAergic
CCGAGAATTCCTACCA-1	MixedregionGABAergic
CCGAGAATGCGTTGGA-1	MixedregionGABAergic
CCGAGAATGATCTTAC-1	MixedregionGABAergic
CCGAGAATCTGATGGT-1	MixedregionGABAergic
CCGAGAATCCGAGAAT-1	MixedregionGABAergic
CCGAGAATGCCGCAAC-1	MixedregionGABAergic
CCGAGAATTGAGTCTG-1	MixedregionGABAergic
CCGAGAATTGCGGACC-1	MixedregionGABAergic
CCGAGAATGGCTGAGC-1	MixedregionGABAergic
CCGAGAATACGGAGGC-1	MixedregionGABAergic
CCGAGAATTAGATCTA-1	MixedregionGABAergic
CCGAGAATAATTAAGA-1	MixedregionGABAergic
CCGAGAATTTATTCAT-1	MixedregionGABAergic
CCGAGAATTGCCGGCA-1	MixedregionGABAergic
CCGAGAATTTACCGAG-1	MixedregionGABAergic
CCGAGAATATCATATT-1	MixedregionGABAergic
CCGAGAATTGGTCAGC-1	MixedregionGABAergic
CCGAGAATACTATGCA-1	MixedregionGABAergic
CCGAGAATCGACGCGA-1	MixedregionGABAergic
CCGAGAATCCGATTCC-1	Undefined
CCGAGAATGATACGGA-1	MixedregionGABAergic
CCGAGAATTTATCCGG-1	MixedregionGABAergic
CCGAGAATTCTGATAC-1	Mixedregionglutamatergic
CCGAGAATTCCGGCCT-1	MixedregionGABAergic
CCGAGAATAGAGAAGG-1	Mixedregionglutamatergic
CCGAGAATCATACTCC-1	MixedregionGABAergic
CCGAGAATGCTAACTT-1	MixedregionGABAergic
CCGAGAATGGTATGCT-1	Mixedregionglutamatergic
CCGAGAATACCGCCAA-1	MixedregionGABAergic
CCGAGAATAACCTGCG-1	Mixedregionglutamatergic
CCGAGAATCCAGTTCC-1	Undefined
CCGAGAATACTTAACC-1	Undefined
CCGAGAATCAACCGCT-1	MixedregionGABAergic
CCGAGAATGACCTTGA-1	Undefined
CTGATGGTATAAGGAG-1	Forebrainglutamatergic
CTGATGGTTAGAGTAA-1	Undefined
CTGATGGTGCAGGTCC-1	Forebrainglutamatergic
CTGATGGTTCGGCCTT-1	MixedregionGABAergic
CTGATGGTAGAACGTC-1	MixedregionGABAergic
CTGATGGTCTTGCGCC-1	MixedregionGABAergic
CTGATGGTGGTACTGC-1	Mixedregionglutamatergic
CTGATGGTTAGAATTA-1	MixedregionGABAergic
CTGATGGTGCCATTCT-1	MixedregionGABAergic
CTGATGGTTTGACTTC-1	Mixedregionglutamatergic
CTGATGGTAGAGCTAT-1	MixedregionGABAergic
CTGATGGTCGAACGCC-1	Hypothalamus
CTGATGGTCTAAGAGA-1	MixedregionGABAergic
CTGATGGTACTCAATA-1	Mixedregionglutamatergic
CTGATGGTTCCTACCA-1	MixedregionGABAergic
CTGATGGTGCGTTGGA-1	MixedregionGABAergic
CTGATGGTGATCTTAC-1	MixedregionGABAergic
CTGATGGTCTGATGGT-1	MixedregionGABAergic
CTGATGGTCCGAGAAT-1	MixedregionGABAergic
CTGATGGTGCCGCAAC-1	MixedregionGABAergic
CTGATGGTTGAGTCTG-1	MixedregionGABAergic
CTGATGGTTGCGGACC-1	MixedregionGABAergic
CTGATGGTGGCTGAGC-1	Forebrainglutamatergic
CTGATGGTACGGAGGC-1	MixedregionGABAergic
CTGATGGTTAGATCTA-1	MixedregionGABAergic
CTGATGGTAATTAAGA-1	MixedregionGABAergic
CTGATGGTTTATTCAT-1	MixedregionGABAergic
CTGATGGTTGCCGGCA-1	MixedregionGABAergic
CTGATGGTTTACCGAG-1	MixedregionGABAergic
CTGATGGTATCATATT-1	MixedregionGABAergic
CTGATGGTTGGTCAGC-1	MixedregionGABAergic
CTGATGGTACTATGCA-1	MixedregionGABAergic
CTGATGGTCGACGCGA-1	MixedregionGABAergic
CTGATGGTCCGATTCC-1	MixedregionGABAergic
CTGATGGTGATACGGA-1	MixedregionGABAergic
CTGATGGTTTATCCGG-1	MixedregionGABAergic
CTGATGGTTCTGATAC-1	MixedregionGABAergic
CTGATGGTAGAGAAGG-1	Mixedregionglutamatergic
CTGATGGTCATACTCC-1	MixedregionGABAergic
CTGATGGTGCTAACTT-1	Undefined
CTGATGGTGGTATGCT-1	MixedregionGABAergic
CTGATGGTACCGCCAA-1	Undefined
CTGATGGTAACCTGCG-1	MixedregionGABAergic
CTGATGGTCCAGTTCC-1	Undefined
CTGATGGTACTTAACC-1	Undefined
CTGATGGTCAACCGCT-1	Mixedregionglutamatergic
CTGATGGTGACCTTGA-1	Undefined
GATCTTACATAAGGAG-1	Mixedregionglutamatergic
GATCTTACTAGAGTAA-1	Undefined
GATCTTACGCAGGTCC-1	Undefined
GATCTTACTCGGCCTT-1	MixedregionGABAergic
GATCTTACAGAACGTC-1	MixedregionGABAergic
GATCTTACCTTGCGCC-1	MixedregionGABAergic
GATCTTACGGTACTGC-1	MixedregionGABAergic
GATCTTACTAGAATTA-1	Mixedregionglutamatergic
GATCTTACGCCATTCT-1	MixedregionGABAergic
GATCTTACTTGACTTC-1	Mixedregionglutamatergic
GATCTTACAGAGCTAT-1	MixedregionGABAergic
GATCTTACCGAACGCC-1	Hypothalamus
GATCTTACCTAAGAGA-1	MixedregionGABAergic
GATCTTACACTCAATA-1	MixedregionGABAergic
GATCTTACTCCTACCA-1	MixedregionGABAergic
GATCTTACGCGTTGGA-1	MixedregionGABAergic
GATCTTACGATCTTAC-1	MixedregionGABAergic
GATCTTACCTGATGGT-1	MixedregionGABAergic
GATCTTACCCGAGAAT-1	MixedregionGABAergic
GATCTTACGCCGCAAC-1	MixedregionGABAergic
GATCTTACTGAGTCTG-1	MixedregionGABAergic
GATCTTACTGCGGACC-1	MixedregionGABAergic
GATCTTACGGCTGAGC-1	Mixedregionandneurotransmitter
GATCTTACACGGAGGC-1	MixedregionGABAergic
GATCTTACTAGATCTA-1	MixedregionGABAergic
GATCTTACAATTAAGA-1	MixedregionGABAergic
GATCTTACTTATTCAT-1	MixedregionGABAergic
GATCTTACTGCCGGCA-1	MixedregionGABAergic
GATCTTACTTACCGAG-1	MixedregionGABAergic
GATCTTACATCATATT-1	MixedregionGABAergic
GATCTTACTGGTCAGC-1	MixedregionGABAergic
GATCTTACACTATGCA-1	MixedregionGABAergic
GATCTTACCGACGCGA-1	MixedregionGABAergic
GATCTTACCCGATTCC-1	MixedregionGABAergic
GATCTTACGATACGGA-1	MixedregionGABAergic
GATCTTACTTATCCGG-1	MixedregionGABAergic
GATCTTACTCTGATAC-1	Mixedregionglutamatergic
GATCTTACAGAGAAGG-1	Mixedregion
GATCTTACCATACTCC-1	MixedregionGABAergic
GATCTTACGCTAACTT-1	MixedregionGABAergic
GATCTTACGGTATGCT-1	Mixedregionglutamatergic
GATCTTACACCGCCAA-1	Undefined
GATCTTACAACCTGCG-1	MidbrainGABAergic
GATCTTACCCAGTTCC-1	Mixedregionglutamatergic
GATCTTACACTTAACC-1	Mixedregionglutamatergic
GATCTTACCAACCGCT-1	MixedregionGABAergic
GATCTTACGACCTTGA-1	Undefined
GCGTTGGAATAAGGAG-1	Undefined
GCGTTGGATAGAGTAA-1	MixedregionGABAergic
GCGTTGGAGCAGGTCC-1	Hypothalamus
GCGTTGGATCGGCCTT-1	MixedregionGABAergic
GCGTTGGAAGAACGTC-1	Mixedregionglutamatergic
GCGTTGGACTTGCGCC-1	MixedregionGABAergic
GCGTTGGAGGTACTGC-1	MixedregionGABAergic
GCGTTGGATAGAATTA-1	MixedregionGABAergic
GCGTTGGAGCCATTCT-1	MixedregionGABAergic
GCGTTGGATTGACTTC-1	Mixedregionglutamatergic
GCGTTGGAAGAGCTAT-1	MixedregionGABAergic
GCGTTGGACGAACGCC-1	Undefined
GCGTTGGACTAAGAGA-1	MixedregionGABAergic
GCGTTGGAACTCAATA-1	MixedregionGABAergic
GCGTTGGATCCTACCA-1	MixedregionGABAergic
GCGTTGGAGCGTTGGA-1	MixedregionGABAergic
GCGTTGGAGATCTTAC-1	MixedregionGABAergic
GCGTTGGACTGATGGT-1	MixedregionGABAergic
GCGTTGGACCGAGAAT-1	MixedregionGABAergic
GCGTTGGAGCCGCAAC-1	MixedregionGABAergic
GCGTTGGATGAGTCTG-1	Mixedregionglutamatergic
GCGTTGGATGCGGACC-1	MixedregionGABAergic
GCGTTGGAGGCTGAGC-1	Undefined
GCGTTGGAACGGAGGC-1	MixedregionGABAergic
GCGTTGGATAGATCTA-1	MixedregionGABAergic
GCGTTGGAAATTAAGA-1	MixedregionGABAergic
GCGTTGGATTATTCAT-1	MixedregionGABAergic
GCGTTGGATGCCGGCA-1	MixedregionGABAergic
GCGTTGGATTACCGAG-1	MixedregionGABAergic
GCGTTGGAATCATATT-1	MixedregionGABAergic
GCGTTGGATGGTCAGC-1	MixedregionGABAergic
GCGTTGGAACTATGCA-1	MixedregionGABAergic
GCGTTGGACGACGCGA-1	MixedregionGABAergic
GCGTTGGACCGATTCC-1	MixedregionGABAergic
GCGTTGGAGATACGGA-1	MixedregionGABAergic
GCGTTGGATTATCCGG-1	MixedregionGABAergic
GCGTTGGATCTGATAC-1	MixedregionGABAergic
GCGTTGGACATACTCC-1	Undefined
GCGTTGGAGCTAACTT-1	MidbrainGABAergic
GCGTTGGAGGTATGCT-1	Mixedregionglutamatergic
GCGTTGGAACCGCCAA-1	Undefined
GCGTTGGAAACCTGCG-1	MixedregionGABAergic
GCGTTGGACCAGTTCC-1	Mixedregionglutamatergic
GCGTTGGAACTTAACC-1	Mixedregionglutamatergic
GCGTTGGACAACCGCT-1	Undefined
GCGTTGGAGACCTTGA-1	Undefined
TCCTACCAATAAGGAG-1	Mixedregionglutamatergic
TCCTACCATAGAGTAA-1	Undefined
TCCTACCAGCAGGTCC-1	Undefined
TCCTACCATCGGCCTT-1	Mixedregionglutamatergic
TCCTACCAAGAACGTC-1	MixedregionGABAergic
TCCTACCACTTGCGCC-1	MixedregionGABAergic
TCCTACCAGGTACTGC-1	MixedregionGABAergic
TCCTACCATAGAATTA-1	MixedregionGABAergic
TCCTACCAGCCATTCT-1	MixedregionGABAergic
TCCTACCATTGACTTC-1	MixedregionGABAergic
TCCTACCAAGAGCTAT-1	MixedregionGABAergic
TCCTACCACGAACGCC-1	Undefined
TCCTACCACTAAGAGA-1	MixedregionGABAergic
TCCTACCAACTCAATA-1	MixedregionGABAergic
TCCTACCATCCTACCA-1	MixedregionGABAergic
TCCTACCAGCGTTGGA-1	MixedregionGABAergic
TCCTACCAGATCTTAC-1	Mixedregionglutamatergic
TCCTACCACTGATGGT-1	MixedregionGABAergic
TCCTACCACCGAGAAT-1	MixedregionGABAergic
TCCTACCAGCCGCAAC-1	MixedregionGABAergic
TCCTACCATGAGTCTG-1	Mixedregionglutamatergic
TCCTACCATGCGGACC-1	MixedregionGABAergic
TCCTACCAGGCTGAGC-1	Undefined
TCCTACCAACGGAGGC-1	MixedregionGABAergic
TCCTACCATAGATCTA-1	Mixedregionglutamatergic
TCCTACCAAATTAAGA-1	MixedregionGABAergic
TCCTACCATTATTCAT-1	MixedregionGABAergic
TCCTACCATGCCGGCA-1	MixedregionGABAergic
TCCTACCATTACCGAG-1	MixedregionGABAergic
TCCTACCAATCATATT-1	MixedregionGABAergic
TCCTACCATGGTCAGC-1	MixedregionGABAergic
TCCTACCAACTATGCA-1	MixedregionGABAergic
TCCTACCACGACGCGA-1	MixedregionGABAergic
TCCTACCACCGATTCC-1	Undefined
TCCTACCAGATACGGA-1	MixedregionGABAergic
TCCTACCATTATCCGG-1	MixedregionGABAergic
TCCTACCATCTGATAC-1	MixedregionGABAergic
TCCTACCACATACTCC-1	Mixedregionglutamatergic
TCCTACCAGCTAACTT-1	Mixedregionglutamatergic
TCCTACCAGGTATGCT-1	Mixedregionglutamatergic
TCCTACCAACCGCCAA-1	Undefined
TCCTACCAAACCTGCG-1	MixedregionGABAergic
TCCTACCACCAGTTCC-1	MixedregionGABAergic
TCCTACCAACTTAACC-1	MixedregionGABAergic
TCCTACCACAACCGCT-1	MixedregionGABAergic
TCCTACCAGACCTTGA-1	Undefined
GGTATGCTTAGAGTAA-1	Undefined
GGTATGCTGCAGGTCC-1	Mixedregionglutamatergic
GGTATGCTTCGGCCTT-1	Mixedregionglutamatergic
GGTATGCTAGAACGTC-1	MixedregionGABAergic
GGTATGCTCTTGCGCC-1	Corticalorhippocampalglutamatergic
GGTATGCTGGTACTGC-1	Corticalorhippocampalglutamatergic
GGTATGCTTAGAATTA-1	Corticalorhippocampalglutamatergic
GGTATGCTGCCATTCT-1	Corticalorhippocampalglutamatergic
GGTATGCTTTGACTTC-1	Mixedregionglutamatergic
GGTATGCTAGAGCTAT-1	Undefined
GGTATGCTCTAAGAGA-1	MixedregionGABAergic
GGTATGCTACTCAATA-1	Undefined
GGTATGCTTCCTACCA-1	Undefined
GGTATGCTGCGTTGGA-1	Undefined
GGTATGCTGATCTTAC-1	Mixedregionglutamatergic
GGTATGCTCTGATGGT-1	MixedregionGABAergic
GGTATGCTCCGAGAAT-1	Mixedregionglutamatergic
GGTATGCTGCCGCAAC-1	MixedregionGABAergic
GGTATGCTTGAGTCTG-1	Mixedregionglutamatergic
GGTATGCTACTTAACC-1	Forebrainglutamatergic
GGTATGCTCAACCGCT-1	Corticalorhippocampalglutamatergic
GGTATGCTGACCTTGA-1	Mixedregionglutamatergic
ACTCAATAATAAGGAG-1	Forebrainglutamatergic
ACTCAATATAGAGTAA-1	Mixedregionandneurotransmitter
ACTCAATAGCAGGTCC-1	Undefined
ACTCAATATCGGCCTT-1	Mixedregionglutamatergic
ACTCAATAAGAACGTC-1	MixedregionGABAergic
ACTCAATACTTGCGCC-1	Undefined
ACTCAATAGGTACTGC-1	Mixedregionglutamatergic
ACTCAATATAGAATTA-1	MixedregionGABAergic
ACTCAATAGCCATTCT-1	MixedregionGABAergic
ACTCAATATTGACTTC-1	MixedregionGABAergic
ACTCAATAAGAGCTAT-1	MixedregionGABAergic
ACTCAATACGAACGCC-1	Mixedregionglutamatergic
ACTCAATACTAAGAGA-1	MixedregionGABAergic
ACTCAATAACTCAATA-1	MixedregionGABAergic
ACTCAATATCCTACCA-1	MixedregionGABAergic
ACTCAATAGCGTTGGA-1	MixedregionGABAergic
ACTCAATAGATCTTAC-1	MixedregionGABAergic
ACTCAATACTGATGGT-1	MixedregionGABAergic
ACTCAATACCGAGAAT-1	Mixedregionglutamatergic
ACTCAATAGCCGCAAC-1	MixedregionGABAergic
ACTCAATATGAGTCTG-1	MixedregionGABAergic
ACTCAATATGCGGACC-1	MixedregionGABAergic
ACTCAATAGGCTGAGC-1	Undefined
ACTCAATAACGGAGGC-1	MixedregionGABAergic
ACTCAATATAGATCTA-1	MixedregionGABAergic
ACTCAATAAATTAAGA-1	MixedregionGABAergic
ACTCAATATTATTCAT-1	Mixedregionglutamatergic
ACTCAATATGCCGGCA-1	Mixedregionglutamatergic
ACTCAATATTACCGAG-1	MixedregionGABAergic
ACTCAATAATCATATT-1	MixedregionGABAergic
ACTCAATATGGTCAGC-1	MixedregionGABAergic
ACTCAATAACTATGCA-1	MixedregionGABAergic
ACTCAATACGACGCGA-1	MixedregionGABAergic
ACTCAATACCGATTCC-1	Undefined
ACTCAATAGATACGGA-1	MixedregionGABAergic
ACTCAATATTATCCGG-1	MixedregionGABAergic
ACTCAATATCTGATAC-1	MixedregionGABAergic
ACTCAATACATACTCC-1	Undefined
ACTCAATAGCTAACTT-1	MixedregionGABAergic
ACTCAATAGGTATGCT-1	Mixedregionglutamatergic
ACTCAATAACCGCCAA-1	Undefined
ACTCAATAAACCTGCG-1	MixedregionGABAergic
ACTCAATACCAGTTCC-1	Mixedregionglutamatergic
ACTCAATAACTTAACC-1	MixedregionGABAergic
ACTCAATACAACCGCT-1	MixedregionGABAergic
ACTCAATAGACCTTGA-1	Undefined
CTAAGAGAATAAGGAG-1	Forebrainglutamatergic
CTAAGAGATAGAGTAA-1	Undefined
CTAAGAGAGCAGGTCC-1	MixedregionGABAergic
CTAAGAGATCGGCCTT-1	Mixedregionandneurotransmitter
CTAAGAGAAGAACGTC-1	Forebrainglutamatergic
CTAAGAGACTTGCGCC-1	ForebrainGABAergic
CTAAGAGAGGTACTGC-1	MixedregionGABAergic
CTAAGAGATAGAATTA-1	Mixedregionglutamatergic
CTAAGAGAGCCATTCT-1	MixedregionGABAergic
CTAAGAGATTGACTTC-1	MixedregionGABAergic
CTAAGAGAAGAGCTAT-1	MixedregionGABAergic
CTAAGAGACGAACGCC-1	MixedregionGABAergic
CTAAGAGACTAAGAGA-1	MixedregionGABAergic
CTAAGAGAACTCAATA-1	Mixedregionglutamatergic
CTAAGAGATCCTACCA-1	MixedregionGABAergic
CTAAGAGAGCGTTGGA-1	MixedregionGABAergic
CTAAGAGAGATCTTAC-1	MixedregionGABAergic
CTAAGAGACTGATGGT-1	MixedregionGABAergic
CTAAGAGACCGAGAAT-1	MixedregionGABAergic
CTAAGAGAGCCGCAAC-1	MixedregionGABAergic
CTAAGAGATGAGTCTG-1	MixedregionGABAergic
CTAAGAGATGCGGACC-1	MixedregionGABAergic
CTAAGAGAGGCTGAGC-1	MixedregionGABAergic
CTAAGAGAACGGAGGC-1	MixedregionGABAergic
CTAAGAGATAGATCTA-1	MixedregionGABAergic
CTAAGAGAAATTAAGA-1	MixedregionGABAergic
CTAAGAGATTATTCAT-1	Undefined
CTAAGAGATGCCGGCA-1	Undefined
CTAAGAGATTACCGAG-1	MixedregionGABAergic
CTAAGAGAATCATATT-1	MixedregionGABAergic
CTAAGAGATGGTCAGC-1	MixedregionGABAergic
CTAAGAGAACTATGCA-1	MixedregionGABAergic
CTAAGAGACGACGCGA-1	MixedregionGABAergic
CTAAGAGACCGATTCC-1	Undefined
CTAAGAGAGATACGGA-1	MixedregionGABAergic
CTAAGAGATTATCCGG-1	Mixedregionglutamatergic
CTAAGAGACATACTCC-1	Mixedregionglutamatergic
CTAAGAGAGCTAACTT-1	Midbrainglutamatergic
CTAAGAGAGGTATGCT-1	Mixedregionglutamatergic
CTAAGAGAACCGCCAA-1	Mixedregionglutamatergic
CTAAGAGAAACCTGCG-1	MixedregionGABAergic
CTAAGAGACCAGTTCC-1	Mixedregionglutamatergic
CTAAGAGAACTTAACC-1	Undefined
CTAAGAGACAACCGCT-1	Undefined
CTAAGAGAGACCTTGA-1	MixedregionGABAergic
AGAGCTATATAAGGAG-1	Undefined
AGAGCTATTAGAGTAA-1	Undefined
AGAGCTATGCAGGTCC-1	Undefined
AGAGCTATTCGGCCTT-1	Undefined
AGAGCTATAGAACGTC-1	Mixedregionglutamatergic
AGAGCTATCTTGCGCC-1	MixedregionGABAergic
AGAGCTATGGTACTGC-1	MixedregionGABAergic
AGAGCTATTAGAATTA-1	MixedregionGABAergic
AGAGCTATGCCATTCT-1	MixedregionGABAergic
AGAGCTATTTGACTTC-1	MixedregionGABAergic
AGAGCTATAGAGCTAT-1	MixedregionGABAergic
AGAGCTATCGAACGCC-1	Corticalorhippocampalglutamatergic
AGAGCTATCTAAGAGA-1	Mixedregionglutamatergic
AGAGCTATACTCAATA-1	Mixedregionglutamatergic
AGAGCTATTCCTACCA-1	MixedregionGABAergic
AGAGCTATGCGTTGGA-1	MixedregionGABAergic
AGAGCTATGATCTTAC-1	MixedregionGABAergic
AGAGCTATCTGATGGT-1	Mixedregionglutamatergic
AGAGCTATCCGAGAAT-1	MixedregionGABAergic
AGAGCTATGCCGCAAC-1	MixedregionGABAergic
AGAGCTATTGAGTCTG-1	MixedregionGABAergic
AGAGCTATTGCGGACC-1	MixedregionGABAergic
AGAGCTATGGCTGAGC-1	Mixedregionglutamatergic
AGAGCTATACGGAGGC-1	Mixedregionglutamatergic
AGAGCTATTAGATCTA-1	MixedregionGABAergic
AGAGCTATAATTAAGA-1	MixedregionGABAergic
AGAGCTATTTATTCAT-1	Mixedregionglutamatergic
AGAGCTATTGCCGGCA-1	MixedregionGABAergic
AGAGCTATTTACCGAG-1	MixedregionGABAergic
AGAGCTATATCATATT-1	MixedregionGABAergic
AGAGCTATTGGTCAGC-1	MixedregionGABAergic
AGAGCTATACTATGCA-1	MixedregionGABAergic
AGAGCTATCGACGCGA-1	MixedregionGABAergic
AGAGCTATCCGATTCC-1	Undefined
AGAGCTATGATACGGA-1	MixedregionGABAergic
AGAGCTATTTATCCGG-1	MixedregionGABAergic
AGAGCTATGCTAACTT-1	Mixedregionglutamatergic
AGAGCTATGGTATGCT-1	Mixedregionglutamatergic
AGAGCTATACCGCCAA-1	MixedregionGABAergic
AGAGCTATAACCTGCG-1	Mixedregionglutamatergic
AGAGCTATCCAGTTCC-1	Forebrainglutamatergic
AGAGCTATACTTAACC-1	Undefined
AGAGCTATCAACCGCT-1	Undefined
AGAGCTATGACCTTGA-1	Undefined
TTGACTTCATAAGGAG-1	MixedregionGABAergic
TTGACTTCTAGAGTAA-1	Undefined
TTGACTTCGCAGGTCC-1	Undefined
TTGACTTCTCGGCCTT-1	MixedregionGABAergic
TTGACTTCAGAACGTC-1	Undefined
TTGACTTCCTTGCGCC-1	Mixedregionglutamatergic
TTGACTTCGGTACTGC-1	MixedregionGABAergic
TTGACTTCTAGAATTA-1	MixedregionGABAergic
TTGACTTCGCCATTCT-1	MixedregionGABAergic
TTGACTTCTTGACTTC-1	MixedregionGABAergic
TTGACTTCAGAGCTAT-1	MixedregionGABAergic
TTGACTTCCGAACGCC-1	Mixedregionglutamatergic
TTGACTTCCTAAGAGA-1	MixedregionGABAergic
TTGACTTCACTCAATA-1	MixedregionGABAergic
TTGACTTCTCCTACCA-1	Mixedregionglutamatergic
TTGACTTCGCGTTGGA-1	Mixedregionglutamatergic
TTGACTTCGATCTTAC-1	Mixedregionglutamatergic
TTGACTTCCTGATGGT-1	MixedregionGABAergic
TTGACTTCCCGAGAAT-1	MixedregionGABAergic
TTGACTTCGCCGCAAC-1	MixedregionGABAergic
TTGACTTCTGAGTCTG-1	MixedregionGABAergic
TTGACTTCTGCGGACC-1	MixedregionGABAergic
TTGACTTCGGCTGAGC-1	Undefined
TTGACTTCACGGAGGC-1	MixedregionGABAergic
TTGACTTCTAGATCTA-1	MixedregionGABAergic
TTGACTTCAATTAAGA-1	MixedregionGABAergic
TTGACTTCTTATTCAT-1	MixedregionGABAergic
TTGACTTCTGCCGGCA-1	MixedregionGABAergic
TTGACTTCTTACCGAG-1	MixedregionGABAergic
TTGACTTCATCATATT-1	MixedregionGABAergic
TTGACTTCTGGTCAGC-1	MixedregionGABAergic
TTGACTTCACTATGCA-1	MixedregionGABAergic
TTGACTTCCGACGCGA-1	MixedregionGABAergic
TTGACTTCCCGATTCC-1	Undefined
TTGACTTCGATACGGA-1	MixedregionGABAergic
TTGACTTCTTATCCGG-1	MixedregionGABAergic
TTGACTTCGCTAACTT-1	Undefined
TTGACTTCGGTATGCT-1	Mixedregionglutamatergic
TTGACTTCACCGCCAA-1	MixedregionGABAergic
TTGACTTCAACCTGCG-1	Mixedregionglutamatergic
TTGACTTCCCAGTTCC-1	Undefined
TTGACTTCACTTAACC-1	Undefined
TTGACTTCCAACCGCT-1	Undefined
TTGACTTCGACCTTGA-1	Undefined
GCCATTCTATAAGGAG-1	Hypothalamus
GCCATTCTTAGAGTAA-1	MixedregionGABAergic
GCCATTCTGCAGGTCC-1	Forebrainglutamatergic
GCCATTCTTCGGCCTT-1	Undefined
GCCATTCTAGAACGTC-1	Undefined
GCCATTCTCTTGCGCC-1	Undefined
GCCATTCTGGTACTGC-1	Forebrainglutamatergic
GCCATTCTTAGAATTA-1	Mixedregionglutamatergic
GCCATTCTGCCATTCT-1	MixedregionGABAergic
GCCATTCTTTGACTTC-1	MixedregionGABAergic
GCCATTCTAGAGCTAT-1	MixedregionGABAergic
GCCATTCTCGAACGCC-1	Mixedregionglutamatergic
GCCATTCTCTAAGAGA-1	MixedregionGABAergic
GCCATTCTACTCAATA-1	MixedregionGABAergic
GCCATTCTTCCTACCA-1	MixedregionGABAergic
GCCATTCTGCGTTGGA-1	Mixedregionglutamatergic
GCCATTCTGATCTTAC-1	MixedregionGABAergic
GCCATTCTCTGATGGT-1	MixedregionGABAergic
GCCATTCTCCGAGAAT-1	Mixedregionglutamatergic
GCCATTCTGCCGCAAC-1	MixedregionGABAergic
GCCATTCTTGAGTCTG-1	Mixedregionglutamatergic
GCCATTCTTGCGGACC-1	MixedregionGABAergic
GCCATTCTGGCTGAGC-1	MixedregionGABAergic
GCCATTCTACGGAGGC-1	MixedregionGABAergic
GCCATTCTTAGATCTA-1	MixedregionGABAergic
GCCATTCTAATTAAGA-1	MixedregionGABAergic
GCCATTCTTTATTCAT-1	MixedregionGABAergic
GCCATTCTTGCCGGCA-1	MixedregionGABAergic
GCCATTCTTTACCGAG-1	MixedregionGABAergic
GCCATTCTATCATATT-1	MixedregionGABAergic
GCCATTCTTGGTCAGC-1	MixedregionGABAergic
GCCATTCTACTATGCA-1	MixedregionGABAergic
GCCATTCTCGACGCGA-1	MixedregionGABAergic
GCCATTCTCCGATTCC-1	Undefined
GCCATTCTGATACGGA-1	MixedregionGABAergic
GCCATTCTTTATCCGG-1	MixedregionGABAergic
GCCATTCTGCTAACTT-1	Undefined
GCCATTCTGGTATGCT-1	Mixedregionglutamatergic
GCCATTCTACCGCCAA-1	Mixedregionandneurotransmitter
GCCATTCTAACCTGCG-1	Mixedregionglutamatergic
GCCATTCTCCAGTTCC-1	Undefined
GCCATTCTACTTAACC-1	MixedregionGABAergic
GCCATTCTCAACCGCT-1	MixedregionGABAergic
GCCATTCTGACCTTGA-1	Undefined
TAGAATTATAGAGTAA-1	Mixedregionglutamatergic
TAGAATTAGCAGGTCC-1	Undefined
TAGAATTATCGGCCTT-1	MixedregionGABAergic
TAGAATTAAGAACGTC-1	Undefined
TAGAATTACTTGCGCC-1	Mixedregionglutamatergic
TAGAATTAGGTACTGC-1	MixedregionGABAergic
TAGAATTATAGAATTA-1	MixedregionGABAergic
TAGAATTAGCCATTCT-1	MixedregionGABAergic
TAGAATTATTGACTTC-1	MixedregionGABAergic
TAGAATTAAGAGCTAT-1	Mixedregionglutamatergic
TAGAATTACGAACGCC-1	Undefined
TAGAATTACTAAGAGA-1	MixedregionGABAergic
TAGAATTAACTCAATA-1	MixedregionGABAergic
TAGAATTATCCTACCA-1	MixedregionGABAergic
TAGAATTAGCGTTGGA-1	MixedregionGABAergic
TAGAATTAGATCTTAC-1	MixedregionGABAergic
TAGAATTACTGATGGT-1	MixedregionGABAergic
TAGAATTACCGAGAAT-1	MixedregionGABAergic
TAGAATTAGCCGCAAC-1	MixedregionGABAergic
TAGAATTATGAGTCTG-1	MixedregionGABAergic
TAGAATTATGCGGACC-1	MixedregionGABAergic
TAGAATTAGGCTGAGC-1	MixedregionGABAergic
TAGAATTAACGGAGGC-1	MixedregionGABAergic
TAGAATTATAGATCTA-1	MixedregionGABAergic
TAGAATTAAATTAAGA-1	MixedregionGABAergic
TAGAATTATTATTCAT-1	Mixedregionglutamatergic
TAGAATTATGCCGGCA-1	MixedregionGABAergic
TAGAATTATTACCGAG-1	Mixedregionglutamatergic
TAGAATTAATCATATT-1	MixedregionGABAergic
TAGAATTATGGTCAGC-1	MixedregionGABAergic
TAGAATTAACTATGCA-1	MixedregionGABAergic
TAGAATTACGACGCGA-1	MixedregionGABAergic
TAGAATTACCGATTCC-1	Undefined
TAGAATTAGATACGGA-1	MixedregionGABAergic
TAGAATTAGCTAACTT-1	Undefined
TAGAATTAGGTATGCT-1	Mixedregionglutamatergic
TAGAATTAACCGCCAA-1	MixedregionGABAergic
TAGAATTAAACCTGCG-1	Mixedregionglutamatergic
TAGAATTACCAGTTCC-1	MixedregionGABAergic
TAGAATTAACTTAACC-1	MixedregionGABAergic
TAGAATTACAACCGCT-1	Undefined
TAGAATTAGACCTTGA-1	Undefined
GGTACTGCTAGAGTAA-1	Undefined
GGTACTGCGCAGGTCC-1	Undefined
GGTACTGCTCGGCCTT-1	Mixedregionglutamatergic
GGTACTGCAGAACGTC-1	MixedregionGABAergic
GGTACTGCCTTGCGCC-1	Mixedregionandneurotransmitter
GGTACTGCGGTACTGC-1	MixedregionGABAergic
GGTACTGCTAGAATTA-1	MixedregionGABAergic
GGTACTGCGCCATTCT-1	MixedregionGABAergic
GGTACTGCTTGACTTC-1	Mixedregionglutamatergic
GGTACTGCAGAGCTAT-1	Undefined
GGTACTGCCGAACGCC-1	Mixedregionandneurotransmitter
GGTACTGCCTAAGAGA-1	MixedregionGABAergic
GGTACTGCACTCAATA-1	MixedregionGABAergic
GGTACTGCTCCTACCA-1	Mixedregionglutamatergic
GGTACTGCGCGTTGGA-1	MixedregionGABAergic
GGTACTGCGATCTTAC-1	Hindbrainglutamatergic
GGTACTGCCTGATGGT-1	MixedregionGABAergic
GGTACTGCCCGAGAAT-1	MixedregionGABAergic
GGTACTGCGCCGCAAC-1	MixedregionGABAergic
GGTACTGCTGAGTCTG-1	MixedregionGABAergic
GGTACTGCTGCGGACC-1	MixedregionGABAergic
GGTACTGCGGCTGAGC-1	Mixedregionglutamatergic
GGTACTGCACGGAGGC-1	MixedregionGABAergic
GGTACTGCTAGATCTA-1	MixedregionGABAergic
GGTACTGCAATTAAGA-1	MixedregionGABAergic
GGTACTGCTTATTCAT-1	MixedregionGABAergic
GGTACTGCTGCCGGCA-1	MixedregionGABAergic
GGTACTGCTTACCGAG-1	MixedregionGABAergic
GGTACTGCATCATATT-1	MixedregionGABAergic
GGTACTGCTGGTCAGC-1	MixedregionGABAergic
GGTACTGCACTATGCA-1	MixedregionGABAergic
GGTACTGCCGACGCGA-1	MixedregionGABAergic
GGTACTGCCCGATTCC-1	Undefined
GGTACTGCGGTATGCT-1	MixedregionGABAergic
GGTACTGCACCGCCAA-1	Undefined
GGTACTGCAACCTGCG-1	Mixedregionglutamatergic
GGTACTGCCCAGTTCC-1	Undefined
GGTACTGCACTTAACC-1	MixedregionGABAergic
GGTACTGCCAACCGCT-1	Undefined
GGTACTGCGACCTTGA-1	MixedregionGABAergic
CTTGCGCCTAGAGTAA-1	Undefined
CTTGCGCCGCAGGTCC-1	Undefined
CTTGCGCCTCGGCCTT-1	Undefined
CTTGCGCCAGAACGTC-1	Undefined
CTTGCGCCCTTGCGCC-1	Undefined
CTTGCGCCGGTACTGC-1	MixedregionGABAergic
CTTGCGCCTAGAATTA-1	Undefined
CTTGCGCCGCCATTCT-1	MixedregionGABAergic
CTTGCGCCTTGACTTC-1	Undefined
CTTGCGCCAGAGCTAT-1	Undefined
CTTGCGCCCTAAGAGA-1	Undefined
CTTGCGCCACTCAATA-1	MixedregionGABAergic
CTTGCGCCTCCTACCA-1	MixedregionGABAergic
CTTGCGCCGCGTTGGA-1	MixedregionGABAergic
CTTGCGCCGATCTTAC-1	MixedregionGABAergic
CTTGCGCCCTGATGGT-1	MixedregionGABAergic
CTTGCGCCCCGAGAAT-1	MixedregionGABAergic
CTTGCGCCGCCGCAAC-1	MixedregionGABAergic
CTTGCGCCTGAGTCTG-1	MixedregionGABAergic
CTTGCGCCTGCGGACC-1	MixedregionGABAergic
CTTGCGCCGGCTGAGC-1	MixedregionGABAergic
CTTGCGCCACGGAGGC-1	MixedregionGABAergic
CTTGCGCCTAGATCTA-1	MixedregionGABAergic
CTTGCGCCAATTAAGA-1	MixedregionGABAergic
CTTGCGCCTTATTCAT-1	MixedregionGABAergic
CTTGCGCCTGCCGGCA-1	MixedregionGABAergic
CTTGCGCCTTACCGAG-1	MixedregionGABAergic
CTTGCGCCATCATATT-1	MixedregionGABAergic
CTTGCGCCTGGTCAGC-1	MixedregionGABAergic
CTTGCGCCACTATGCA-1	MixedregionGABAergic
CTTGCGCCCGACGCGA-1	Undefined
CTTGCGCCCCGATTCC-1	Undefined
CTTGCGCCGATACGGA-1	Mixedregionglutamatergic
CTTGCGCCGGTATGCT-1	Mixedregionglutamatergic
CTTGCGCCACCGCCAA-1	Undefined
CTTGCGCCAACCTGCG-1	MixedregionGABAergic
CTTGCGCCCCAGTTCC-1	MixedregionGABAergic
CTTGCGCCACTTAACC-1	Undefined
CTTGCGCCCAACCGCT-1	MixedregionGABAergic
CTTGCGCCGACCTTGA-1	MixedregionGABAergic
AGAACGTCTAGAGTAA-1	Mixedregionglutamatergic
AGAACGTCGCAGGTCC-1	Undefined
AGAACGTCTCGGCCTT-1	MixedregionGABAergic
AGAACGTCAGAACGTC-1	Mixedregionglutamatergic
AGAACGTCCTTGCGCC-1	MixedregionGABAergic
AGAACGTCGGTACTGC-1	MixedregionGABAergic
AGAACGTCTAGAATTA-1	Undefined
AGAACGTCGCCATTCT-1	MixedregionGABAergic
AGAACGTCTTGACTTC-1	Mixedregionglutamatergic
AGAACGTCAGAGCTAT-1	Mixedregionglutamatergic
AGAACGTCCTAAGAGA-1	Undefined
AGAACGTCACTCAATA-1	Mixedregionglutamatergic
AGAACGTCTCCTACCA-1	MixedregionGABAergic
AGAACGTCGCGTTGGA-1	Hindbrainglutamatergic
AGAACGTCGATCTTAC-1	MixedregionGABAergic
AGAACGTCCTGATGGT-1	MixedregionGABAergic
AGAACGTCCCGAGAAT-1	MixedregionGABAergic
AGAACGTCGCCGCAAC-1	MixedregionGABAergic
AGAACGTCTGAGTCTG-1	MixedregionGABAergic
AGAACGTCTGCGGACC-1	MixedregionGABAergic
AGAACGTCACGGAGGC-1	MixedregionGABAergic
AGAACGTCTAGATCTA-1	MixedregionGABAergic
AGAACGTCAATTAAGA-1	MixedregionGABAergic
AGAACGTCTTATTCAT-1	MixedregionGABAergic
AGAACGTCTGCCGGCA-1	MixedregionGABAergic
AGAACGTCTTACCGAG-1	MixedregionGABAergic
AGAACGTCATCATATT-1	MixedregionGABAergic
AGAACGTCTGGTCAGC-1	MixedregionGABAergic
AGAACGTCACTATGCA-1	Undefined
AGAACGTCCGACGCGA-1	Mixedregionglutamatergic
AGAACGTCCCGATTCC-1	Mixedregionglutamatergic
AGAACGTCGATACGGA-1	MixedregionGABAergic
AGAACGTCTCTGATAC-1	Mixedregionandneurotransmitter
AGAACGTCGCTAACTT-1	Mixedregionglutamatergic
AGAACGTCGGTATGCT-1	MixedregionGABAergic
AGAACGTCACCGCCAA-1	MixedregionGABAergic
AGAACGTCAACCTGCG-1	MidbrainGABAergic
AGAACGTCCCAGTTCC-1	Mixedregionglutamatergic
AGAACGTCACTTAACC-1	MixedregionGABAergic
AGAACGTCCAACCGCT-1	Mixedregionglutamatergic
AGAACGTCGACCTTGA-1	Undefined
TCGGCCTTTAGAGTAA-1	Undefined
TCGGCCTTGCAGGTCC-1	Undefined
TCGGCCTTTCGGCCTT-1	MixedregionGABAergic
TCGGCCTTAGAACGTC-1	Undefined
TCGGCCTTCTTGCGCC-1	MixedregionGABAergic
TCGGCCTTGGTACTGC-1	Undefined
TCGGCCTTTAGAATTA-1	Mixedregionglutamatergic
TCGGCCTTGCCATTCT-1	Undefined
TCGGCCTTTTGACTTC-1	MixedregionGABAergic
TCGGCCTTAGAGCTAT-1	MixedregionGABAergic
TCGGCCTTCTAAGAGA-1	Undefined
TCGGCCTTACTCAATA-1	Mixedregionglutamatergic
TCGGCCTTTCCTACCA-1	Mixedregionglutamatergic
TCGGCCTTGCGTTGGA-1	MixedregionGABAergic
TCGGCCTTGATCTTAC-1	MixedregionGABAergic
TCGGCCTTCTGATGGT-1	MixedregionGABAergic
TCGGCCTTCCGAGAAT-1	MixedregionGABAergic
TCGGCCTTGCCGCAAC-1	MixedregionGABAergic
TCGGCCTTTGAGTCTG-1	MixedregionGABAergic
TCGGCCTTTGCGGACC-1	MixedregionGABAergic
TCGGCCTTACGGAGGC-1	MixedregionGABAergic
TCGGCCTTTAGATCTA-1	MixedregionGABAergic
TCGGCCTTAATTAAGA-1	MixedregionGABAergic
TCGGCCTTTTATTCAT-1	MixedregionGABAergic
TCGGCCTTTGCCGGCA-1	MixedregionGABAergic
TCGGCCTTTTACCGAG-1	MixedregionGABAergic
TCGGCCTTACTATGCA-1	MixedregionGABAergic
TCGGCCTTCGACGCGA-1	MixedregionGABAergic
TCGGCCTTCCGATTCC-1	Mixedregionglutamatergic
TCGGCCTTGATACGGA-1	Hindbrainglycinergic
TCGGCCTTTTATCCGG-1	MixedregionGABAergic
TCGGCCTTTCTGATAC-1	MixedregionGABAergic
TCGGCCTTGGTATGCT-1	Mixedregionglutamatergic
TCGGCCTTACCGCCAA-1	Undefined
TCGGCCTTAACCTGCG-1	MixedregionGABAergic
TCGGCCTTCCAGTTCC-1	Mixedregionglutamatergic
TCGGCCTTACTTAACC-1	Mixedregionglutamatergic
TCGGCCTTCAACCGCT-1	MixedregionGABAergic
TCGGCCTTGACCTTGA-1	Undefined
GCTAACTTTAGAGTAA-1	Mixedregionglutamatergic
GCTAACTTGCAGGTCC-1	MixedregionGABAergic
GCTAACTTTCGGCCTT-1	Undefined
GCTAACTTAGAACGTC-1	Undefined
GCTAACTTCTTGCGCC-1	Undefined
GCTAACTTGGTACTGC-1	Corticalorhippocampalglutamatergic
GCTAACTTTAGAATTA-1	Corticalorhippocampalglutamatergic
GCTAACTTGCCATTCT-1	MixedregionGABAergic
GCTAACTTTTGACTTC-1	MixedregionGABAergic
GCTAACTTAGAGCTAT-1	ForebrainGABAergic
GCTAACTTCTAAGAGA-1	Corticalorhippocampalglutamatergic
GCTAACTTACTCAATA-1	Corticalorhippocampalglutamatergic
GCTAACTTTCCTACCA-1	Corticalorhippocampalglutamatergic
GCTAACTTGCGTTGGA-1	Corticalorhippocampalglutamatergic
GCTAACTTGATCTTAC-1	Corticalorhippocampalglutamatergic
GCTAACTTCTGATGGT-1	Corticalorhippocampalglutamatergic
GCTAACTTCCGAGAAT-1	MixedregionGABAergic
GCTAACTTGCCGCAAC-1	Undefined
GCTAACTTTGAGTCTG-1	MixedregionGABAergic
GCTAACTTTGCGGACC-1	MixedregionGABAergic
GCTAACTTACGGAGGC-1	MixedregionGABAergic
GCTAACTTACCGCCAA-1	HindbrainGABAergic
GCTAACTTCCAGTTCC-1	Pia3
GCTAACTTACTTAACC-1	Hypothalamus
GCTAACTTCAACCGCT-1	Undefined
GCTAACTTGACCTTGA-1	Forebrainglutamatergic
GCAGGTCCTAGAGTAA-1	Undefined
GCAGGTCCGCAGGTCC-1	Undefined
GCAGGTCCTCGGCCTT-1	Undefined
GCAGGTCCAGAACGTC-1	Undefined
GCAGGTCCCTTGCGCC-1	Mixedregionglutamatergic
GCAGGTCCGGTACTGC-1	MixedregionGABAergic
GCAGGTCCTAGAATTA-1	Undefined
GCAGGTCCGCCATTCT-1	MixedregionGABAergic
GCAGGTCCTTGACTTC-1	Undefined
GCAGGTCCAGAGCTAT-1	Undefined
GCAGGTCCCTAAGAGA-1	MixedregionGABAergic
GCAGGTCCACTCAATA-1	MixedregionGABAergic
GCAGGTCCTCCTACCA-1	MixedregionGABAergic
GCAGGTCCGCGTTGGA-1	MixedregionGABAergic
GCAGGTCCGATCTTAC-1	MixedregionGABAergic
GCAGGTCCCTGATGGT-1	MixedregionGABAergic
GCAGGTCCCCGAGAAT-1	MixedregionGABAergic
GCAGGTCCGCCGCAAC-1	MixedregionGABAergic
GCAGGTCCTGAGTCTG-1	MixedregionGABAergic
GCAGGTCCTGCGGACC-1	MixedregionGABAergic
GCAGGTCCACGGAGGC-1	MixedregionGABAergic
GCAGGTCCTAGATCTA-1	MixedregionGABAergic
GCAGGTCCAATTAAGA-1	MixedregionGABAergic
GCAGGTCCTTATTCAT-1	MixedregionGABAergic
GCAGGTCCTGCCGGCA-1	MixedregionGABAergic
GCAGGTCCACTATGCA-1	MixedregionGABAergic
GCAGGTCCCGACGCGA-1	HindbrainGABAergic
GCAGGTCCGATACGGA-1	HindbrainGABAergic
GCAGGTCCTTATCCGG-1	Mixedregionglutamatergic
GCAGGTCCTCTGATAC-1	Mixedregionglutamatergic
GCAGGTCCGAAGATCG-1	Mixedregionglutamatergic
GCAGGTCCGGTATGCT-1	Mixedregionandneurotransmitter
GCAGGTCCACCGCCAA-1	ForebrainGABAergic
GCAGGTCCAACCTGCG-1	MixedregionGABAergic
GCAGGTCCCCAGTTCC-1	Undefined
GCAGGTCCACTTAACC-1	Undefined
GCAGGTCCCAACCGCT-1	Undefined
GCAGGTCCGACCTTGA-1	MixedregionGABAergic
TAGAGTAATAGAGTAA-1	MixedregionGABAergic
TAGAGTAAGCAGGTCC-1	Undefined
TAGAGTAATCGGCCTT-1	MixedregionGABAergic
TAGAGTAAAGAACGTC-1	Undefined
TAGAGTAACTTGCGCC-1	MixedregionGABAergic
TAGAGTAAGGTACTGC-1	Undefined
TAGAGTAATAGAATTA-1	Undefined
TAGAGTAAGCCATTCT-1	Mixedregionglutamatergic
TAGAGTAATTGACTTC-1	Undefined
TAGAGTAAAGAGCTAT-1	Mixedregionglutamatergic
TAGAGTAACTAAGAGA-1	Undefined
TAGAGTAAACTCAATA-1	MixedregionGABAergic
TAGAGTAATCCTACCA-1	MixedregionGABAergic
TAGAGTAAGCGTTGGA-1	MixedregionGABAergic
TAGAGTAAGATCTTAC-1	MixedregionGABAergic
TAGAGTAACTGATGGT-1	MixedregionGABAergic
TAGAGTAACCGAGAAT-1	MixedregionGABAergic
TAGAGTAAGCCGCAAC-1	MixedregionGABAergic
TAGAGTAATGAGTCTG-1	MixedregionGABAergic
TAGAGTAATGCGGACC-1	MixedregionGABAergic
TAGAGTAAACGGAGGC-1	Hindbrain
TAGAGTAATAGATCTA-1	MixedregionGABAergic
TAGAGTAAAATTAAGA-1	MixedregionGABAergic
TAGAGTAAACTATGCA-1	Hindbrain
TAGAGTAACGACGCGA-1	HindbrainGABAergic
TAGAGTAAGATACGGA-1	Hindbrainglycinergic
TAGAGTAATTATCCGG-1	Mixedregionglutamatergic
TAGAGTAATCTGATAC-1	Midbrainglutamatergic
TAGAGTAAGAAGATCG-1	Midbrain
TAGAGTAACATACTCC-1	MidbrainGABAergic
TAGAGTAAGCTAACTT-1	Undefined
TAGAGTAAGGTATGCT-1	Undefined
TAGAGTAAACCGCCAA-1	Mixedregionglutamatergic
TAGAGTAACCAGTTCC-1	Undefined
TAGAGTAAACTTAACC-1	Mixedregionglutamatergic
TAGAGTAACAACCGCT-1	Undefined
TAGAGTAAGACCTTGA-1	Undefined
GACCTTGATAGAGTAA-1	Undefined
GACCTTGAGCAGGTCC-1	Undefined
GACCTTGATCGGCCTT-1	Undefined
GACCTTGAAGAACGTC-1	MixedregionGABAergic
GACCTTGACTTGCGCC-1	MixedregionGABAergic
GACCTTGAGGTACTGC-1	MixedregionGABAergic
GACCTTGATAGAATTA-1	Undefined
GACCTTGAGCCATTCT-1	Undefined
GACCTTGATTGACTTC-1	MixedregionGABAergic
GACCTTGAAGAGCTAT-1	Undefined
GACCTTGACTAAGAGA-1	Undefined
GACCTTGAACTCAATA-1	Mixedregionglutamatergic
GACCTTGATCCTACCA-1	MixedregionGABAergic
GACCTTGAGCGTTGGA-1	MixedregionGABAergic
GACCTTGAGATCTTAC-1	MixedregionGABAergic
GACCTTGACTGATGGT-1	MixedregionGABAergic
GACCTTGACCGAGAAT-1	MixedregionGABAergic
GACCTTGAGCCGCAAC-1	MixedregionGABAergic
GACCTTGATGAGTCTG-1	MixedregionGABAergic
GACCTTGATGCGGACC-1	MixedregionGABAergic
GACCTTGAACGGAGGC-1	MixedregionGABAergic
GACCTTGAACTATGCA-1	MixedregionGABAergic
GACCTTGACGACGCGA-1	MixedregionGABAergic
GACCTTGAGATACGGA-1	HindbrainGABAergic
GACCTTGATTATCCGG-1	MixedregionGABAergic
GACCTTGATCTGATAC-1	Midbrainglutamatergic
GACCTTGAGAAGATCG-1	Midbrain
GACCTTGAAAGAAGCT-1	Midbrainglutamatergic
GACCTTGAAGAGAAGG-1	MidbrainGABAergic
GACCTTGACATACTCC-1	Midbrainglutamatergic
GACCTTGAGCTAACTT-1	MixedregionGABAergic
GACCTTGAGGTATGCT-1	Undefined
GACCTTGACCAGTTCC-1	Undefined
GACCTTGAACTTAACC-1	Mixedregionglutamatergic
GACCTTGACAACCGCT-1	Undefined
GACCTTGAGACCTTGA-1	Undefined
CAACCGCTTAGAGTAA-1	Undefined
CAACCGCTGCAGGTCC-1	Undefined
CAACCGCTTCGGCCTT-1	Mixedregionglutamatergic
CAACCGCTAGAACGTC-1	Undefined
CAACCGCTCTTGCGCC-1	Undefined
CAACCGCTGGTACTGC-1	MixedregionGABAergic
CAACCGCTTAGAATTA-1	Undefined
CAACCGCTGCCATTCT-1	Undefined
CAACCGCTTTGACTTC-1	MixedregionGABAergic
CAACCGCTAGAGCTAT-1	Mixedregionglutamatergic
CAACCGCTCTAAGAGA-1	Undefined
CAACCGCTACTCAATA-1	Undefined
CAACCGCTTCCTACCA-1	MixedregionGABAergic
CAACCGCTGCGTTGGA-1	MixedregionGABAergic
CAACCGCTGATCTTAC-1	MixedregionGABAergic
CAACCGCTCTGATGGT-1	MixedregionGABAergic
CAACCGCTCCGAGAAT-1	MixedregionGABAergic
CAACCGCTGCCGCAAC-1	MixedregionGABAergic
CAACCGCTTGAGTCTG-1	MixedregionGABAergic
CAACCGCTTGCGGACC-1	MixedregionGABAergic
CAACCGCTACGGAGGC-1	Hindbrain
CAACCGCTTTACCGAG-1	Mixedregionglutamatergic
CAACCGCTCGACGCGA-1	MixedregionGABAergic
CAACCGCTGATACGGA-1	MixedregionGABAergic
CAACCGCTTTATCCGG-1	MixedregionGABAergic
CAACCGCTTCTGATAC-1	MixedregionGABAergic
CAACCGCTGAAGATCG-1	Midbrainglutamatergic
CAACCGCTAAGAAGCT-1	MixedregionGABAergic
CAACCGCTTCCGGCCT-1	Midbrainglutamatergic
CAACCGCTAGAGAAGG-1	Midbrainglutamatergic
CAACCGCTCATACTCC-1	Undefined
CAACCGCTGCTAACTT-1	Midbrainglutamatergic
CAACCGCTACTTAACC-1	Undefined
CAACCGCTCAACCGCT-1	Undefined
CAACCGCTGACCTTGA-1	Undefined
ACTTAACCTAGAGTAA-1	Undefined
ACTTAACCGCAGGTCC-1	Undefined
ACTTAACCTCGGCCTT-1	MixedregionGABAergic
ACTTAACCAGAACGTC-1	Undefined
ACTTAACCCTTGCGCC-1	Undefined
ACTTAACCGGTACTGC-1	Mixedregionandneurotransmitter
ACTTAACCTAGAATTA-1	Forebrainglutamatergic
ACTTAACCGCCATTCT-1	Undefined
ACTTAACCTTGACTTC-1	Undefined
ACTTAACCAGAGCTAT-1	Undefined
ACTTAACCCTAAGAGA-1	MixedregionGABAergic
ACTTAACCACTCAATA-1	MixedregionGABAergic
ACTTAACCTCCTACCA-1	MixedregionGABAergic
ACTTAACCGCGTTGGA-1	MixedregionGABAergic
ACTTAACCGATCTTAC-1	MixedregionGABAergic
ACTTAACCCTGATGGT-1	MixedregionGABAergic
ACTTAACCCCGAGAAT-1	MixedregionGABAergic
ACTTAACCGCCGCAAC-1	MixedregionGABAergic
ACTTAACCTGAGTCTG-1	MixedregionGABAergic
ACTTAACCTGCGGACC-1	MixedregionGABAergic
ACTTAACCACGGAGGC-1	MixedregionGABAergic
ACTTAACCTAGATCTA-1	Mixedregionglutamatergic
ACTTAACCTGCCGGCA-1	MixedregionGABAergic
ACTTAACCTTACCGAG-1	MixedregionGABAergic
ACTTAACCATCATATT-1	MixedregionGABAergic
ACTTAACCACTATGCA-1	Undefined
ACTTAACCCGACGCGA-1	MixedregionGABAergic
ACTTAACCGATACGGA-1	MixedregionGABAergic
ACTTAACCTTATCCGG-1	MixedregionGABAergic
ACTTAACCTCTGATAC-1	Undefined
ACTTAACCGAAGATCG-1	MixedregionGABAergic
ACTTAACCAAGAAGCT-1	Midbrainglutamatergic
ACTTAACCTCCGGCCT-1	Midbrainglutamatergic
ACTTAACCAGAGAAGG-1	Midbrain
ACTTAACCACTTAACC-1	Undefined
ACTTAACCCAACCGCT-1	MixedregionGABAergic
ACTTAACCGACCTTGA-1	MixedregionGABAergic
CCAGTTCCTAGAGTAA-1	MixedregionGABAergic
CCAGTTCCGCAGGTCC-1	Undefined
CCAGTTCCTCGGCCTT-1	Undefined
CCAGTTCCAGAACGTC-1	MixedregionGABAergic
CCAGTTCCCTTGCGCC-1	MixedregionGABAergic
CCAGTTCCGGTACTGC-1	MixedregionGABAergic
CCAGTTCCTAGAATTA-1	Undefined
CCAGTTCCGCCATTCT-1	Undefined
CCAGTTCCTTGACTTC-1	Undefined
CCAGTTCCAGAGCTAT-1	Undefined
CCAGTTCCCTAAGAGA-1	Undefined
CCAGTTCCACTCAATA-1	MixedregionGABAergic
CCAGTTCCTCCTACCA-1	MixedregionGABAergic
CCAGTTCCGCGTTGGA-1	MixedregionGABAergic
CCAGTTCCGATCTTAC-1	MixedregionGABAergic
CCAGTTCCCTGATGGT-1	MixedregionGABAergic
CCAGTTCCCCGAGAAT-1	MixedregionGABAergic
CCAGTTCCGCCGCAAC-1	MixedregionGABAergic
CCAGTTCCTGAGTCTG-1	MixedregionGABAergic
CCAGTTCCTGCGGACC-1	MixedregionGABAergic
CCAGTTCCACGGAGGC-1	MixedregionGABAergic
CCAGTTCCTAGATCTA-1	Undefined
CCAGTTCCTTACCGAG-1	Undefined
CCAGTTCCATCATATT-1	MixedregionGABAergic
CCAGTTCCACTATGCA-1	Mixedregionglutamatergic
CCAGTTCCCGACGCGA-1	Undefined
CCAGTTCCGATACGGA-1	CerebellumGABAergic
CCAGTTCCTTATCCGG-1	Undefined
CCAGTTCCGAAGATCG-1	Midbrainglutamatergic
CCAGTTCCAAGAAGCT-1	Undefined
CCAGTTCCCAACCGCT-1	Mixedregionglutamatergic
CCAGTTCCGACCTTGA-1	MixedregionGABAergic
ACCGCCAATAGAGTAA-1	Undefined
ACCGCCAAGCAGGTCC-1	Undefined
ACCGCCAATCGGCCTT-1	Forebrainglutamatergic
ACCGCCAAAGAACGTC-1	MixedregionGABAergic
ACCGCCAACTTGCGCC-1	MixedregionGABAergic
ACCGCCAAGGTACTGC-1	MixedregionGABAergic
ACCGCCAATAGAATTA-1	MixedregionGABAergic
ACCGCCAAGCCATTCT-1	Mixedregionglutamatergic
ACCGCCAATTGACTTC-1	Undefined
ACCGCCAAAGAGCTAT-1	MixedregionGABAergic
ACCGCCAACTAAGAGA-1	Undefined
ACCGCCAAACTCAATA-1	Undefined
ACCGCCAATCCTACCA-1	MixedregionGABAergic
ACCGCCAAGCGTTGGA-1	MixedregionGABAergic
ACCGCCAAGATCTTAC-1	MixedregionGABAergic
ACCGCCAACTGATGGT-1	MixedregionGABAergic
ACCGCCAACCGAGAAT-1	MixedregionGABAergic
ACCGCCAAGCCGCAAC-1	MixedregionGABAergic
ACCGCCAATGAGTCTG-1	MixedregionGABAergic
ACCGCCAATGCGGACC-1	MixedregionGABAergic
ACCGCCAAACGGAGGC-1	MixedregionGABAergic
ACCGCCAATAGATCTA-1	MixedregionGABAergic
ACCGCCAAAATTAAGA-1	MixedregionGABAergic
ACCGCCAATTACCGAG-1	Mixedregionglutamatergic
ACCGCCAAATCATATT-1	MixedregionGABAergic
ACCGCCAATGGTCAGC-1	Undefined
ACCGCCAAACTATGCA-1	Undefined
ACCGCCAACGACGCGA-1	MixedregionGABAergic
ACCGCCAAGATACGGA-1	Mixedregionglutamatergic
ACCGCCAACAACCGCT-1	Undefined
ACCGCCAAGACCTTGA-1	Mixedregionglutamatergic
CCGATTCCTAGAGTAA-1	Mixedregionglutamatergic
CCGATTCCGCAGGTCC-1	Undefined
CCGATTCCTCGGCCTT-1	Undefined
CCGATTCCAGAACGTC-1	Undefined
CCGATTCCCTTGCGCC-1	Forebrainglutamatergic
CCGATTCCGGTACTGC-1	Undefined
CCGATTCCTAGAATTA-1	MixedregionGABAergic
CCGATTCCGCCATTCT-1	MixedregionGABAergic
CCGATTCCTTGACTTC-1	Undefined
CCGATTCCAGAGCTAT-1	Undefined
CCGATTCCCTAAGAGA-1	MixedregionGABAergic
CCGATTCCACTCAATA-1	MixedregionGABAergic
CCGATTCCTCCTACCA-1	MixedregionGABAergic
CCGATTCCGCGTTGGA-1	MixedregionGABAergic
CCGATTCCGATCTTAC-1	Mixedregionglutamatergic
CCGATTCCCTGATGGT-1	MixedregionGABAergic
CCGATTCCCCGAGAAT-1	MixedregionGABAergic
CCGATTCCGCCGCAAC-1	MixedregionGABAergic
CCGATTCCTGAGTCTG-1	MixedregionGABAergic
CCGATTCCTGCGGACC-1	MixedregionGABAergic
CCGATTCCACGGAGGC-1	MixedregionGABAergic
CCGATTCCTAGATCTA-1	MixedregionGABAergic
CCGATTCCAATTAAGA-1	MixedregionGABAergic
CCGATTCCATCATATT-1	MixedregionGABAergic
CCGATTCCTGGTCAGC-1	Undefined
CCGATTCCACTATGCA-1	MixedregionGABAergic
CCGATTCCCGACGCGA-1	Undefined
CCGATTCCGACCTTGA-1	MixedregionGABAergic
GGCTGAGCTAGAGTAA-1	Undefined
GGCTGAGCGCAGGTCC-1	Undefined
GGCTGAGCTCGGCCTT-1	Undefined
GGCTGAGCAGAACGTC-1	MixedregionGABAergic
GGCTGAGCCTTGCGCC-1	MixedregionGABAergic
GGCTGAGCGGTACTGC-1	Undefined
GGCTGAGCTAGAATTA-1	Undefined
GGCTGAGCGCCATTCT-1	MixedregionGABAergic
GGCTGAGCTTGACTTC-1	Mixedregionglutamatergic
GGCTGAGCAGAGCTAT-1	MixedregionGABAergic
GGCTGAGCCTAAGAGA-1	Undefined
GGCTGAGCACTCAATA-1	Undefined
GGCTGAGCTCCTACCA-1	MixedregionGABAergic
GGCTGAGCGCGTTGGA-1	Mixedregionglutamatergic
GGCTGAGCGATCTTAC-1	MixedregionGABAergic
GGCTGAGCCTGATGGT-1	MixedregionGABAergic
GGCTGAGCCCGAGAAT-1	MixedregionGABAergic
GGCTGAGCGCCGCAAC-1	MixedregionGABAergic
GGCTGAGCTGAGTCTG-1	Mixedregionglutamatergic
GGCTGAGCTGCGGACC-1	MixedregionGABAergic
GGCTGAGCACGGAGGC-1	MixedregionGABAergic
GGCTGAGCTAGATCTA-1	MixedregionGABAergic
GGCTGAGCAATTAAGA-1	MixedregionGABAergic
GGCTGAGCTTATTCAT-1	MixedregionGABAergic
GGCTGAGCGACCTTGA-1	MixedregionGABAergic
CGAACGCCTAGAGTAA-1	Undefined
CGAACGCCGCAGGTCC-1	MixedregionGABAergic
CGAACGCCTCGGCCTT-1	Undefined
CGAACGCCAGAACGTC-1	Undefined
CGAACGCCCTTGCGCC-1	Undefined
CGAACGCCGGTACTGC-1	MixedregionGABAergic
CGAACGCCTAGAATTA-1	Undefined
CGAACGCCGCCATTCT-1	Mixedregionglutamatergic
CGAACGCCTTGACTTC-1	MixedregionGABAergic
CGAACGCCAGAGCTAT-1	Undefined
CGAACGCCCTAAGAGA-1	Undefined
CGAACGCCACTCAATA-1	Undefined
CGAACGCCTCCTACCA-1	MixedregionGABAergic
CGAACGCCGCGTTGGA-1	MixedregionGABAergic
CGAACGCCGATCTTAC-1	MixedregionGABAergic
CGAACGCCCTGATGGT-1	MixedregionGABAergic
CGAACGCCCCGAGAAT-1	MixedregionGABAergic
CGAACGCCGCCGCAAC-1	MixedregionGABAergic
CGAACGCCTGAGTCTG-1	MixedregionGABAergic
CGAACGCCTGCGGACC-1	MixedregionGABAergic
CGAACGCCACGGAGGC-1	MixedregionGABAergic
CGAACGCCTAGATCTA-1	MixedregionGABAergic
CGAACGCCAATTAAGA-1	MixedregionGABAergic
CGAACGCCTTATTCAT-1	MixedregionGABAergic
CGAACGCCTGCCGGCA-1	MixedregionGABAergic
CATACTCCTAGAGTAA-1	Undefined
CATACTCCGCAGGTCC-1	Undefined
CATACTCCTCGGCCTT-1	MixedregionGABAergic
CATACTCCAGAACGTC-1	Corticalorhippocampalglutamatergic
CATACTCCCTTGCGCC-1	Corticalorhippocampalglutamatergic
CATACTCCGGTACTGC-1	Corticalorhippocampalglutamatergic
CATACTCCTAGAATTA-1	Corticalorhippocampalglutamatergic
CATACTCCGCCATTCT-1	Forebrainglutamatergic
CATACTCCTTGACTTC-1	Corticalorhippocampalglutamatergic
CATACTCCAGAGCTAT-1	Corticalorhippocampalglutamatergic
CATACTCCCTAAGAGA-1	Corticalorhippocampalglutamatergic
CATACTCCACTCAATA-1	Corticalorhippocampalglutamatergic
CATACTCCTCCTACCA-1	Corticalorhippocampalglutamatergic
CATACTCCGCGTTGGA-1	Corticalorhippocampalglutamatergic
CATACTCCGATCTTAC-1	Mixedregionglutamatergic
CATACTCCCTGATGGT-1	Mixedregionglutamatergic
CATACTCCCCGAGAAT-1	MixedregionGABAergic
CATACTCCGCCGCAAC-1	Corticalorhippocampalglutamatergic
CATACTCCTGAGTCTG-1	MixedregionGABAergic
CATACTCCTGCGGACC-1	MixedregionGABAergic
CATACTCCGGCTGAGC-1	Hypothalamus
CATACTCCACGGAGGC-1	Mixedregionglutamatergic
CATACTCCTAGATCTA-1	Mixedregionglutamatergic
CATACTCCAATTAAGA-1	Mixedregionglutamatergic
CATACTCCCCGATTCC-1	Undefined
CATACTCCACCGCCAA-1	Mixedregionglutamatergic
CATACTCCCCAGTTCC-1	MixedregionGABAergic
CATACTCCACTTAACC-1	Mixedregionglutamatergic
CATACTCCCAACCGCT-1	Undefined
CATACTCCGACCTTGA-1	Undefined
ATAAGGAGGCAGGTCC-1	MixedregionGABAergic
ATAAGGAGTCGGCCTT-1	Mixedregionandneurotransmitter
ATAAGGAGAGAACGTC-1	MixedregionGABAergic
ATAAGGAGCTTGCGCC-1	Forebrainglutamatergic
ATAAGGAGGGTACTGC-1	MixedregionGABAergic
ATAAGGAGTAGAATTA-1	Mixedregionandneurotransmitter
ATAAGGAGGCCATTCT-1	MixedregionGABAergic
ATAAGGAGTTGACTTC-1	Undefined
ATAAGGAGAGAGCTAT-1	MixedregionGABAergic
ATAAGGAGCTAAGAGA-1	Undefined
ATAAGGAGACTCAATA-1	MixedregionGABAergic
ATAAGGAGTCCTACCA-1	Undefined
ATAAGGAGGCGTTGGA-1	Undefined
ATAAGGAGGATCTTAC-1	MixedregionGABAergic
ATAAGGAGCTGATGGT-1	MixedregionGABAergic
ATAAGGAGCCGAGAAT-1	MixedregionGABAergic
ATAAGGAGGCCGCAAC-1	MixedregionGABAergic
ATAAGGAGTGAGTCTG-1	MixedregionGABAergic
ATAAGGAGTGCGGACC-1	MixedregionGABAergic
ATAAGGAGACGGAGGC-1	MixedregionGABAergic
ATAAGGAGTAGATCTA-1	MixedregionGABAergic
ATAAGGAGAATTAAGA-1	Undefined
ATAAGGAGTTATTCAT-1	MixedregionGABAergic
ATAAGGAGTGCCGGCA-1	MixedregionGABAergic
AGAGAAGGATAAGGAG-1	Hypothalamus
AGAGAAGGTAGAGTAA-1	MixedregionGABAergic
AGAGAAGGGCAGGTCC-1	Undefined
AGAGAAGGTCGGCCTT-1	Undefined
AGAGAAGGAGAACGTC-1	Corticalorhippocampalglutamatergic
AGAGAAGGCTTGCGCC-1	Corticalorhippocampalglutamatergic
AGAGAAGGGGTACTGC-1	Corticalorhippocampalglutamatergic
AGAGAAGGTAGAATTA-1	Forebrainglutamatergic
AGAGAAGGGCCATTCT-1	Forebrainglutamatergic
AGAGAAGGTTGACTTC-1	Forebrainglutamatergic
AGAGAAGGAGAGCTAT-1	Forebrainglutamatergic
AGAGAAGGCGAACGCC-1	MidbrainGABAergic
AGAGAAGGCTAAGAGA-1	Forebrainglutamatergic
AGAGAAGGACTCAATA-1	Forebrainglutamatergic
AGAGAAGGTCCTACCA-1	Forebrainglutamatergic
AGAGAAGGGCGTTGGA-1	Forebrainglutamatergic
AGAGAAGGGATCTTAC-1	Forebrainglutamatergic
AGAGAAGGCTGATGGT-1	Forebrainglutamatergic
AGAGAAGGCCGAGAAT-1	Corticalorhippocampalglutamatergic
AGAGAAGGGCCGCAAC-1	Corticalorhippocampalglutamatergic
AGAGAAGGTGAGTCTG-1	Corticalorhippocampalglutamatergic
AGAGAAGGTGCGGACC-1	Corticalorhippocampalglutamatergic
AGAGAAGGGGCTGAGC-1	Undefined
AGAGAAGGACGGAGGC-1	MixedregionGABAergic
AGAGAAGGTAGATCTA-1	Undefined
AGAGAAGGAATTAAGA-1	Mixedregionglutamatergic
AGAGAAGGTTATTCAT-1	Undefined
AGAGAAGGTGCCGGCA-1	MixedregionGABAergic
AGAGAAGGCCGATTCC-1	Pia3
AGAGAAGGACCGCCAA-1	MixedregionGABAergic
AGAGAAGGCCAGTTCC-1	Mixedregionglutamatergic
AGAGAAGGACTTAACC-1	Undefined
AGAGAAGGCAACCGCT-1	Undefined
AGAGAAGGGACCTTGA-1	Undefined
TCCGGCCTATAAGGAG-1	Hindbrainglutamatergic
TCCGGCCTTAGAGTAA-1	Corticalorhippocampalglutamatergic
TCCGGCCTGCAGGTCC-1	Mixedregionglutamatergic
TCCGGCCTTCGGCCTT-1	Corticalorhippocampalglutamatergic
TCCGGCCTAGAACGTC-1	Corticalorhippocampalglutamatergic
TCCGGCCTCTTGCGCC-1	Corticalorhippocampalglutamatergic
TCCGGCCTGGTACTGC-1	Forebrainglutamatergic
TCCGGCCTTAGAATTA-1	Forebrainglutamatergic
TCCGGCCTGCCATTCT-1	Forebrainglutamatergic
TCCGGCCTTTGACTTC-1	Forebrainglutamatergic
TCCGGCCTAGAGCTAT-1	Forebrainglutamatergic
TCCGGCCTCGAACGCC-1	Mixedregionandneurotransmitter
TCCGGCCTCTAAGAGA-1	Forebrainglutamatergic
TCCGGCCTACTCAATA-1	Forebrainglutamatergic
TCCGGCCTTCCTACCA-1	Forebrainglutamatergic
TCCGGCCTGCGTTGGA-1	Forebrainglutamatergic
TCCGGCCTGATCTTAC-1	Forebrainglutamatergic
TCCGGCCTCTGATGGT-1	Forebrainglutamatergic
TCCGGCCTCCGAGAAT-1	Forebrainglutamatergic
TCCGGCCTGCCGCAAC-1	Forebrainglutamatergic
TCCGGCCTTGAGTCTG-1	Corticalorhippocampalglutamatergic
TCCGGCCTTGCGGACC-1	Corticalorhippocampalglutamatergic
TCCGGCCTGGCTGAGC-1	Undefined
TCCGGCCTACGGAGGC-1	Corticalorhippocampalglutamatergic
TCCGGCCTTAGATCTA-1	MixedregionGABAergic
TCCGGCCTAATTAAGA-1	Undefined
TCCGGCCTTTATTCAT-1	Undefined
TCCGGCCTTGCCGGCA-1	MixedregionGABAergic
TCCGGCCTTTACCGAG-1	MixedregionGABAergic
TCCGGCCTCCGATTCC-1	Pia3
TCCGGCCTACCGCCAA-1	Undefined
TCCGGCCTCCAGTTCC-1	Undefined
TCCGGCCTACTTAACC-1	Undefined
TCCGGCCTCAACCGCT-1	MixedregionGABAergic
TCCGGCCTGACCTTGA-1	MixedregionGABAergic
AAGAAGCTATAAGGAG-1	Hypothalamus
AAGAAGCTTAGAGTAA-1	Corticalorhippocampalglutamatergic
AAGAAGCTGCAGGTCC-1	Corticalorhippocampalglutamatergic
AAGAAGCTTCGGCCTT-1	Corticalorhippocampalglutamatergic
AAGAAGCTAGAACGTC-1	Forebrainglutamatergic
AAGAAGCTCTTGCGCC-1	Forebrainglutamatergic
AAGAAGCTGGTACTGC-1	Forebrainglutamatergic
AAGAAGCTTAGAATTA-1	Forebrainglutamatergic
AAGAAGCTGCCATTCT-1	Forebrainglutamatergic
AAGAAGCTTTGACTTC-1	Forebrainglutamatergic
AAGAAGCTAGAGCTAT-1	Forebrainglutamatergic
AAGAAGCTCGAACGCC-1	MixedregionGABAergic
AAGAAGCTCTAAGAGA-1	MixedregionGABAergic
AAGAAGCTACTCAATA-1	Forebrain
AAGAAGCTTCCTACCA-1	MixedregionGABAergic
AAGAAGCTGCGTTGGA-1	Forebrainglutamatergic
AAGAAGCTGATCTTAC-1	MixedregionGABAergic
AAGAAGCTCTGATGGT-1	Forebrainglutamatergic
AAGAAGCTCCGAGAAT-1	Forebrainglutamatergic
AAGAAGCTGCCGCAAC-1	Forebrainglutamatergic
AAGAAGCTTGAGTCTG-1	Forebrainglutamatergic
AAGAAGCTTGCGGACC-1	Forebrainglutamatergic
AAGAAGCTGGCTGAGC-1	Undefined
AAGAAGCTACGGAGGC-1	Corticalorhippocampalglutamatergic
AAGAAGCTTAGATCTA-1	Corticalorhippocampalglutamatergic
AAGAAGCTAATTAAGA-1	Corticalorhippocampalglutamatergic
AAGAAGCTTTATTCAT-1	MixedregionGABAergic
AAGAAGCTTGCCGGCA-1	Undefined
AAGAAGCTTTACCGAG-1	MixedregionGABAergic
AAGAAGCTATCATATT-1	MixedregionGABAergic
AAGAAGCTTGGTCAGC-1	MixedregionGABAergic
AAGAAGCTCCGATTCC-1	Undefined
AAGAAGCTACCGCCAA-1	Undefined
AAGAAGCTCCAGTTCC-1	Undefined
AAGAAGCTACTTAACC-1	Mixedregionglutamatergic
AAGAAGCTCAACCGCT-1	MixedregionGABAergic
AAGAAGCTGACCTTGA-1	Corticalorhippocampalglutamatergic
GAAGATCGATAAGGAG-1	Hindbrainglutamatergic
GAAGATCGTAGAGTAA-1	Forebrainglutamatergic
GAAGATCGGCAGGTCC-1	Forebrainglutamatergic
GAAGATCGTCGGCCTT-1	Forebrainglutamatergic
GAAGATCGAGAACGTC-1	Forebrainglutamatergic
GAAGATCGCTTGCGCC-1	Forebrainglutamatergic
GAAGATCGGGTACTGC-1	Mixedregionglutamatergic
GAAGATCGTAGAATTA-1	Forebrain
GAAGATCGGCCATTCT-1	Forebrain
GAAGATCGTTGACTTC-1	Undefined
GAAGATCGCGAACGCC-1	Undefined
GAAGATCGCTGATGGT-1	MixedregionGABAergic
GAAGATCGCCGAGAAT-1	MixedregionGABAergic
GAAGATCGGCCGCAAC-1	MixedregionGABAergic
GAAGATCGTGAGTCTG-1	MixedregionGABAergic
GAAGATCGTGCGGACC-1	Forebrainglutamatergic
GAAGATCGGGCTGAGC-1	MixedregionGABAergic
GAAGATCGACGGAGGC-1	Forebrainglutamatergic
GAAGATCGTAGATCTA-1	Forebrainglutamatergic
GAAGATCGAATTAAGA-1	Corticalorhippocampalglutamatergic
GAAGATCGTTATTCAT-1	Corticalorhippocampalglutamatergic
GAAGATCGTGCCGGCA-1	Corticalorhippocampalglutamatergic
GAAGATCGTTACCGAG-1	MixedregionGABAergic
GAAGATCGATCATATT-1	MixedregionGABAergic
GAAGATCGTGGTCAGC-1	Undefined
GAAGATCGCCGATTCC-1	Undefined
GAAGATCGACCGCCAA-1	Undefined
GAAGATCGCCAGTTCC-1	Mixedregionglutamatergic
GAAGATCGACTTAACC-1	MixedregionGABAergic
GAAGATCGCAACCGCT-1	MixedregionGABAergic
GAAGATCGGACCTTGA-1	Mixedregionglutamatergic
TCTGATACATAAGGAG-1	MixedregionGABAergic
TCTGATACTAGAGTAA-1	Forebrainglutamatergic
TCTGATACGCAGGTCC-1	Forebrainglutamatergic
TCTGATACTCGGCCTT-1	Forebrainglutamatergic
TCTGATACAGAACGTC-1	ForebrainGABAergic
TCTGATACCTTGCGCC-1	ForebrainGABAergic
TCTGATACGGTACTGC-1	MixedregionGABAergic
TCTGATACTAGAATTA-1	ForebrainGABAergic
TCTGATACGCCATTCT-1	MixedregionGABAergic
TCTGATACTTGACTTC-1	Forebrain
TCTGATACAGAGCTAT-1	ForebrainGABAergic
TCTGATACCGAACGCC-1	Forebrainglutamatergic
TCTGATACCTAAGAGA-1	Forebrain
TCTGATACACTCAATA-1	Forebrain
TCTGATACTCCTACCA-1	Undefined
TCTGATACTGAGTCTG-1	Mixedregionglutamatergic
TCTGATACTGCGGACC-1	MixedregionGABAergic
TCTGATACGGCTGAGC-1	Undefined
TCTGATACACGGAGGC-1	MixedregionGABAergic
TCTGATACTAGATCTA-1	Forebrainglutamatergic
TCTGATACAATTAAGA-1	Forebrainglutamatergic
TCTGATACTTATTCAT-1	Forebrainglutamatergic
TCTGATACTGCCGGCA-1	Corticalorhippocampalglutamatergic
TCTGATACTTACCGAG-1	MixedregionGABAergic
TCTGATACATCATATT-1	Undefined
TCTGATACTGGTCAGC-1	Undefined
TCTGATACACTATGCA-1	Undefined
TCTGATACCGACGCGA-1	Undefined
TCTGATACCCGATTCC-1	Undefined
TCTGATACACCGCCAA-1	Undefined
TCTGATACCCAGTTCC-1	Mixedregionglutamatergic
TCTGATACACTTAACC-1	MixedregionGABAergic
TCTGATACCAACCGCT-1	Forebrainglutamatergic
TCTGATACGACCTTGA-1	Forebrainglutamatergic
